Date,Directories,Files,"Lines of Code (LOC)","Cyclomatic Complexity / Lines of Code","Comment Lines of Code (CLOC)","Non-Comment Lines of Code (NCLOC)",Namespaces,Interfaces,Traits,Classes,"Abstract Classes","Concrete Classes","Average Class Length (NCLOC)",Methods,"Non-Static Methods","Static Methods","Public Methods","Non-Public Methods","Average Method Length (NCLOC)","Cyclomatic Complexity / Number of Methods","Anonymous Functions",Functions,Constants,"Global Constants","Class Constants"
"Fri May 17 01:38:43 2013 -0700",136,656,240616,0.059968755177882,71628,168988,0,7,0,1019,14,1005,168.90677134446,6323,5808,515,5611,712,27.220623121936,2.562707575518,0,35,112,74,38
"Thu May 9 12:18:26 2013 -0400",136,656,240534,0.05997999088342,71611,168923,0,7,0,1019,14,1005,168.8390578999,6319,5804,515,5607,712,27.226934641557,2.5633802816901,0,35,112,74,38
"Mon May 6 09:21:45 2013 -0700",136,656,240476,0.0599970392302,71601,168875,0,7,0,1019,14,1005,168.79391560353,6319,5804,515,5607,712,27.219655008704,2.5633802816901,0,35,112,74,38
"Wed May 1 09:46:57 2013 -0400",136,656,240427,0.060043590533273,71583,168844,0,7,0,1019,14,1005,168.76054955839,6316,5801,515,5604,712,27.227200759975,2.5650728309056,0,35,112,74,38
"Mon Apr 29 07:34:06 2013 -0700",136,656,240404,0.060025353647845,71592,168812,0,7,0,1019,14,1005,168.73110893032,6314,5799,515,5602,712,27.231073804245,2.5650934431422,0,35,112,74,38
"Thu Apr 25 14:58:39 2013 -0700",136,656,240281,0.060043150457585,71569,168712,0,7,0,1019,14,1005,168.62806673209,6309,5794,515,5597,712,27.236012046283,2.56585829767,0,35,112,74,38
"Mon Apr 22 11:36:17 2013 +0200",136,656,240252,0.060039836858579,71564,168688,0,7,0,1019,14,1005,168.60942100098,6308,5793,515,5596,712,27.23731769182,2.5659480025365,0,35,112,74,38
"Thu Apr 18 21:22:50 2013 -0400",136,656,240184,0.060077209087189,71551,168633,0,7,0,1019,14,1005,168.55348380765,6306,5791,515,5594,712,27.236917221694,2.5669203932762,0,35,112,74,38
"Tue Apr 9 21:30:20 2013 -0400",136,656,240142,0.060088611574071,71541,168601,0,7,0,1019,14,1005,168.51619234544,6304,5789,515,5593,711,27.239530456853,2.5674175126904,0,35,114,76,38
"Sun Mar 31 00:23:03 2013 +0530",136,656,240085,0.060072495150181,71522,168563,0,7,0,1019,14,1005,168.48282630029,6302,5787,515,5591,711,27.242780069819,2.5675975880673,0,35,114,76,38
"Wed Mar 27 00:12:24 2013 +0530",136,656,240036,0.060067526271755,71509,168527,0,7,0,1019,14,1005,168.44749754661,6301,5786,515,5590,711,27.241390255515,2.5673702586891,0,35,114,76,38
"Mon Mar 18 21:27:00 2013 -0400",136,657,240021,0.06006576370176,71539,168482,0,7,0,1020,14,1006,168.23921568627,6303,5788,515,5591,712,27.225765508488,2.5663969538315,0,35,114,76,38
"Thu Mar 14 07:23:51 2013 -0700",136,656,239920,0.060081581275494,71499,168421,0,7,0,1019,14,1005,168.34249263984,6299,5784,515,5588,711,27.233052865534,2.5672328941102,0,35,114,76,38
"Tue Mar 5 20:58:03 2013 -0500",136,656,239889,0.060064607308702,71487,168402,0,7,0,1019,14,1005,168.33169774289,6298,5783,515,5587,711,27.235630358844,2.566846617974,0,35,114,76,38
"Fri Mar 1 13:37:52 2013 +0100",136,656,239818,0.060078060487967,71487,168331,0,7,0,1019,14,1005,168.26202158979,6298,5783,515,5587,711,27.224356938711,2.5665290568434,0,35,114,76,38
"Sun Feb 24 09:07:15 2013 -0800",136,656,239615,0.060097268630272,71421,168194,0,7,0,1015,14,1001,168.79507389163,6294,5779,515,5583,711,27.220686367969,2.5667302192564,0,35,114,76,38
"Wed Feb 13 22:48:56 2013 -0500",136,656,239522,0.060075778754587,71401,168121,0,7,0,1015,14,1001,168.71921182266,6291,5776,515,5580,711,27.22142743602,2.5662056906692,0,35,114,76,38
"Sat Feb 9 14:06:24 2013 -0500",136,656,239452,0.060083181112294,71385,168067,0,7,0,1015,14,1001,168.66305418719,6289,5774,515,5578,711,27.221020830021,2.5663857529019,0,35,114,76,38
"Fri Feb 8 21:08:15 2013 +0900",136,656,238807,0.060083538609832,70741,168066,0,7,0,1015,14,1001,168.66206896552,6289,5774,515,5578,711,27.220861822229,2.5663857529019,0,35,114,76,38
"Mon Feb 4 09:26:50 2013 +0100",136,656,238665,0.060129691491452,70728,167937,0,7,0,1015,14,1001,168.53300492611,6287,5772,515,5576,711,27.208684587244,2.566884046445,0,35,114,76,38
"Wed Jan 30 13:54:09 2013 +0100",136,655,238463,0.060147733365104,70593,167870,0,7,0,1015,14,1001,168.48472906404,6285,5771,514,5574,711,27.209546539379,2.5672235481305,0,35,114,76,38
"Sat Jan 26 21:16:26 2013 -0500",136,655,238333,0.060145087356418,70572,167761,0,7,0,1015,14,1001,168.3802955665,6282,5768,514,5572,710,27.205666985037,2.5674944285259,0,35,114,76,38
"Fri Jan 11 17:35:39 2013 +0530",136,655,238160,0.060178470170412,70625,167535,0,7,0,1015,14,1001,168.1645320197,6277,5764,513,5567,710,27.192448621953,2.5674685359248,0,35,114,76,38
"Tue Jan 8 20:15:46 2013 -0500",136,655,238021,0.060169866090094,70595,167426,0,7,0,1015,14,1001,168.05320197044,6272,5760,512,5564,708,27.196109693878,2.5674426020408,0,35,114,76,38
"Fri Dec 28 02:02:05 2012 +0530",136,655,237833,0.060182334479151,70558,167275,0,7,0,1015,14,1001,167.89753694581,6266,5754,512,5558,708,27.196935844239,2.5678263645069,0,35,114,76,38
"Sun Dec 23 00:23:01 2012 +0100",136,655,237772,0.060238009807439,70552,167220,0,7,0,1015,14,1001,167.84236453202,6265,5753,512,5561,704,27.192338387869,2.5690343176377,0,35,114,76,38
"Thu Dec 20 17:46:07 2012 -0800",136,655,237708,0.060231161310393,70552,167156,0,7,0,1015,14,1001,167.77733990148,6263,5752,511,5559,704,27.190483793709,2.5687370269839,0,35,114,76,38
"Sun Dec 16 13:32:38 2012 -0500",136,655,237627,0.060292366517272,70508,167119,0,7,0,1015,14,1001,167.73891625616,6261,5750,511,5558,703,27.192940424852,2.57051589203,0,35,114,76,38
"Mon Dec 10 17:06:06 2012 +0100",136,655,237427,0.060245798545812,70461,166966,0,7,0,1015,14,1001,167.57438423645,6257,5746,511,5555,702,27.183634329551,2.5688029407064,0,35,114,76,38
"Sun Dec 2 07:49:08 2012 -0800",136,655,237354,0.06028621575804,70417,166937,0,7,0,1015,14,1001,167.53793103448,6249,5738,511,5555,694,27.21251400224,2.5716114578333,0,35,114,76,38
"Wed Nov 28 18:33:39 2012 -0800",136,655,237025,0.060322696737044,70305,166720,0,7,0,1015,14,1001,167.30541871921,6234,5723,511,5542,692,27.240134744947,2.5742701315367,0,35,114,76,38
"Sat Nov 24 10:09:35 2012 -0800",136,655,236891,0.060339397865716,70184,166707,0,7,0,1015,14,1001,167.27881773399,6232,5721,511,5541,691,27.244544287548,2.5750962772786,0,35,114,76,38
"Wed Nov 14 21:50:29 2012 -0500",136,655,236581,0.060256156215661,70042,166539,0,7,0,1015,14,1001,167.05123152709,6226,5715,511,5535,691,27.233697398008,2.572759396081,0,35,114,76,38
"Fri Nov 9 22:32:29 2012 -0500",136,654,236235,0.060321965710712,69944,166291,0,7,0,1014,14,1000,166.97238658777,6220,5709,511,5529,691,27.220257234727,2.5737942122186,0,35,114,76,38
"Fri Nov 2 08:12:48 2012 +0700",136,654,235891,0.06037203922797,69887,166004,0,7,0,1014,14,1000,166.67948717949,6212,5701,511,5522,690,27.207501609788,2.5743721828719,0,35,114,76,38
"Sat Oct 27 22:50:02 2012 -0400",136,654,235914,0.060364039367328,69888,166026,0,7,0,1014,14,1000,166.70118343195,6212,5701,511,5522,690,27.211043142305,2.5743721828719,0,35,114,76,38
"Wed Oct 24 21:00:56 2012 -0400",136,654,235748,0.060368783040079,69851,165897,0,7,0,1014,14,1000,166.56804733728,6207,5697,510,5518,689,27.211213146448,2.5745126470114,0,35,114,76,38
"Sat Oct 20 20:48:11 2012 -0400",136,654,235695,0.060438699096796,69841,165854,0,7,0,1014,14,1000,166.5157790927,6205,5695,510,5516,689,27.211442385173,2.5761482675262,0,35,114,76,38
"Sun Oct 7 20:17:31 2012 +0530",136,654,235381,0.060509438747781,69787,165594,0,7,0,1014,14,1000,166.24950690335,6197,5688,509,5508,689,27.203001452316,2.5775375181539,0,35,114,76,38
"Mon Oct 1 09:30:08 2012 -0700",136,654,235123,0.060533887854535,69695,165428,0,7,0,1014,14,1000,166.07396449704,6188,5680,508,5500,688,27.213800904977,2.5788623141564,0,35,112,76,36
"Thu Sep 27 17:38:58 2012 -0700",136,654,235025,0.060551080146116,69677,165348,0,7,0,1014,14,1000,165.99013806706,6186,5678,508,5498,688,27.208858713223,2.5790494665373,0,35,112,76,36
"Mon Sep 24 01:26:29 2012 -0700",136,653,234836,0.060593589619444,69604,165232,0,7,0,1013,14,999,166.03751233959,6177,5669,508,5490,687,27.229399384815,2.5813501699854,0,35,112,76,36
"Tue Sep 18 00:59:27 2012 -0700",136,653,234568,0.060631214139003,69521,165047,0,7,0,1013,14,999,165.84304047384,6168,5661,507,5482,686,27.237191958495,2.5828469520104,0,35,112,76,36
"Thu Sep 13 21:05:10 2012 -0400",136,653,234309,0.060631239310537,69427,164882,0,7,0,1013,14,999,165.66337611056,6151,5647,504,5465,686,27.282880832385,2.5855958380751,0,35,112,76,36
"Thu Sep 13 00:10:22 2012 -0700",136,653,234089,0.060682588055316,69363,164726,0,7,0,1013,14,999,165.5064165844,6146,5642,504,5461,685,27.279205987634,2.5867230719167,0,35,109,76,33
"Mon Sep 3 20:09:13 2012 -0400",135,652,233975,0.060609190095497,69363,164612,0,7,0,1012,14,998,165.64031620553,6144,5640,504,5459,685,27.283203125,2.58740234375,0,35,109,76,33
"Thu Aug 30 16:35:36 2012 +0100",135,651,233527,0.060649041534519,69254,164273,0,7,0,1012,14,998,165.34387351779,6130,5627,503,5446,684,27.296574225122,2.5887438825449,0,35,109,76,33
"Sat Aug 25 17:31:21 2012 -0400",135,651,233409,0.060654609250787,69250,164159,0,7,0,1012,14,998,165.23023715415,6129,5626,503,5445,684,27.282264643498,2.5880241474955,0,35,109,76,33
"Thu Aug 23 13:16:34 2012 -0700",135,651,233336,0.060645578028166,69235,164101,0,7,0,1012,14,998,165.16996047431,6126,5623,503,5442,684,27.285667646099,2.5879856349984,0,35,109,76,33
"Fri Aug 10 21:48:22 2012 -0400",135,649,232734,0.060686950625806,69025,163709,0,7,0,1010,14,996,165.10297029703,6105,5603,502,5422,683,27.314332514333,2.5906633906634,0,35,109,76,33
"Wed Aug 8 13:13:28 2012 +0200",135,649,232500,0.060651457432693,68959,163541,0,7,0,1009,14,995,165.10009910803,6096,5595,501,5416,680,27.327099737533,2.5905511811024,0,35,109,76,33
"Thu Aug 2 21:34:45 2012 -0400",135,649,231923,0.060689849670157,68815,163108,0,7,0,1008,14,994,164.80654761905,6077,5576,501,5400,677,27.336679282541,2.5922330097087,0,35,109,76,33
"Sun Jul 22 21:28:49 2012 -0400",135,648,231509,0.060663210143503,68725,162784,0,7,0,1007,14,993,164.64448857994,6069,5568,501,5394,675,27.318668643928,2.5908716427748,0,35,107,76,31
"Sat Jul 21 07:02:34 2012 -0700",135,647,231212,0.060659921891817,68617,162595,0,7,0,1006,14,992,164.61033797217,6060,5562,498,5386,674,27.326402640264,2.5912541254125,0,35,107,76,31
"Sun Jul 15 09:11:27 2012 -0400",135,647,230819,0.060628465804067,68519,162300,0,7,0,1005,14,991,164.4736318408,6040,5543,497,5369,671,27.366887417219,2.5927152317881,0,35,107,76,31
"Sun Jul 1 17:35:24 2012 -0430",135,647,230453,0.060731943681446,68446,162007,0,7,0,1005,14,991,164.1671641791,6030,5533,497,5360,670,27.361194029851,2.593864013267,0,35,107,76,31
"Sun Jun 24 11:29:31 2012 -0400",135,647,230388,0.060737018218636,68411,161977,0,7,0,1005,14,991,164.13134328358,6022,5526,496,5352,670,27.391564264364,2.5958153437396,0,35,107,76,31
"Tue Jun 19 18:35:36 2012 +0200",135,647,230437,0.060775697127551,68415,162022,0,7,0,1005,14,991,164.17611940299,6022,5526,496,5352,670,27.399036864829,2.5973098638326,0,35,107,76,31
"Fri Jun 1 20:38:38 2012 +0200",135,647,230322,0.060813982213439,68402,161920,0,7,0,1005,14,991,164.07263681592,6020,5524,496,5350,670,27.390863787375,2.5978405315615,0,35,107,76,31
"Sat Jun 9 15:27:22 2012 -0430",135,647,230223,0.06084366755025,68382,161841,0,7,0,1005,14,991,163.99004975124,6017,5521,496,5348,669,27.390726275553,2.5986371946153,0,35,107,76,31
"Thu Jun 7 08:43:05 2012 +0200",135,647,230126,0.060851826667491,68356,161770,0,7,0,1005,14,991,163.91542288557,6015,5519,496,5346,669,27.387364921031,2.5986699916874,0,35,107,76,31
"Sun Jun 3 21:11:20 2012 -0400",135,647,230005,0.060843205790467,68360,161645,0,7,0,1004,14,990,163.95717131474,6015,5519,496,5344,671,27.367082294264,2.5971737323358,0,35,107,76,31
"Wed May 30 15:39:43 2012 -0700",134,645,229570,0.06088002579557,68302,161268,0,7,0,1001,14,987,164.06993006993,5997,5502,495,5327,670,27.386026346507,2.5991328997832,0,35,107,76,31
"Sun May 27 19:18:14 2012 +0200",134,645,229355,0.060847545989424,68231,161124,0,7,0,1001,14,987,163.91608391608,5990,5499,491,5320,670,27.392320534224,2.5986644407346,0,35,107,76,31
"Tue May 22 21:27:05 2012 -0400",134,645,229257,0.060866109462128,68215,161042,0,7,0,1001,14,987,163.84315684316,5987,5496,491,5318,669,27.393853348923,2.5991314514782,0,35,107,76,31
"Sat May 12 20:33:56 2012 +0530",134,645,229064,0.060889129205278,68165,160899,0,7,0,1001,14,987,163.69230769231,5981,5490,491,5313,668,27.396087610767,2.5998996823274,0,35,107,76,31
"Tue May 15 10:38:46 2012 +0700",132,640,226498,0.061300900855624,67316,159182,0,7,0,996,14,982,162.69578313253,5886,5396,490,5228,658,27.530581039755,2.6190961603806,0,35,107,76,31
"Sun May 13 04:43:21 2012 -0700",132,640,226074,0.061373158364892,67112,158962,0,7,0,996,14,982,162.44176706827,5876,5391,485,5220,656,27.534377127297,2.6204901293397,0,35,113,82,31
"Sat May 12 21:09:15 2012 -0400",132,640,226073,0.061403453590413,67108,158965,0,7,0,996,14,982,162.44578313253,5876,5391,485,5220,656,27.535057862491,2.6213410483322,0,35,113,82,31
"Sat May 12 00:18:47 2012 +0530",132,640,225813,0.061974386272151,67070,158743,0,7,0,996,14,982,162.23293172691,5871,5387,484,5215,656,27.522398228581,2.6358371657299,0,35,113,82,31
"Thu May 10 00:05:30 2012 -0430",132,636,224899,0.061908225546314,66794,158105,0,7,0,990,13,977,162.59393939394,5837,5364,473,5185,652,27.577180058249,2.6371423676546,0,35,113,82,31
"Mon May 7 21:48:58 2012 +0100",132,636,224770,0.061914194761058,66761,158009,0,7,0,990,13,977,162.49191919192,5834,5361,473,5182,652,27.574048680151,2.6371271854645,0,35,113,82,31
"Wed May 9 17:48:44 2012 -0700",132,636,224569,0.061980093891955,66728,157841,0,7,0,990,13,977,162.31414141414,5830,5357,473,5179,651,27.562778730703,2.6380789022298,0,35,114,83,31
"Sat May 5 17:20:44 2012 -0700",132,636,224539,0.061962603202362,66718,157821,0,7,0,990,13,977,162.29191919192,5830,5357,473,5179,651,27.559005145798,2.6373927958834,0,35,114,83,31
"Mon Apr 30 17:16:08 2012 -0700",132,636,224115,0.062005511601031,66629,157486,0,7,0,990,13,977,161.94141414141,5818,5346,472,5168,650,27.556204881403,2.6383636988656,0,35,114,83,31
"Thu Apr 26 20:19:03 2012 -0400",132,636,224014,0.062006048130924,66610,157404,0,7,0,990,13,977,161.85353535354,5814,5342,472,5164,650,27.560199518404,2.6386308909529,0,35,114,83,31
"Tue Apr 24 20:01:13 2012 -0400",132,635,223933,0.062014666446373,66567,157366,0,7,0,988,13,975,162.14473684211,5813,5341,472,5164,649,27.558747634612,2.6387407534836,0,35,114,83,31
"Sun Apr 22 19:14:24 2012 -0430",132,635,223653,0.061960919013816,66441,157212,0,7,0,988,13,975,161.97064777328,5785,5317,468,5140,645,27.662402765774,2.6435609334486,0,35,114,83,31
"Fri Apr 13 09:36:43 2012 +0530",129,627,221684,0.062066754304402,65739,155945,0,7,0,979,12,967,162.13278855975,5708,5242,466,5071,637,27.807988787666,2.6548703573931,0,35,114,83,31
"Sun Apr 15 22:20:34 2012 -0400",129,626,221332,0.062066485125623,65628,155704,0,7,0,977,12,965,162.20266120778,5695,5229,466,5060,635,27.826514486392,2.6553116769096,0,35,114,83,31
"Fri Apr 6 21:46:34 2012 -0400",129,624,218379,0.062198492789903,64983,153396,0,7,0,974,12,962,160.26488706366,5614,5180,434,4985,629,27.805130032063,2.6572853580335,0,35,114,83,31
"Sun Apr 1 18:19:08 2012 -0700",129,624,218166,0.062220597928591,64937,153229,0,7,0,973,12,961,160.25282631038,5609,5176,433,4982,627,27.799251203423,2.6575147085042,0,35,114,83,31
"Tue Mar 20 20:54:41 2012 -0400",129,624,217806,0.06223399038933,64851,152955,0,7,0,971,12,959,160.28939237899,5594,5162,432,4972,622,27.822845906328,2.6592777976403,0,35,114,83,31
"Sun Mar 11 22:31:53 2012 +0530",129,624,218031,0.062017021720969,64815,153216,0,7,0,971,12,959,160.53964984552,5566,5135,431,4948,618,28.00646784046,2.6645706072584,0,35,114,83,31
"Mon Mar 12 20:31:33 2012 -0400",129,624,217671,0.062066755604384,64755,152916,0,7,0,971,12,959,160.22142121524,5556,5126,430,4942,614,28.001259899208,2.6655867530598,0,35,114,83,31
"Sat Mar 10 22:29:35 2012 -0500",129,624,217252,0.062107201604289,64661,152591,0,7,0,970,12,958,160.03917525773,5542,5112,430,4928,614,28.011187297005,2.6672681342476,0,35,114,83,31
"Wed Mar 7 19:52:06 2012 -0500",129,624,217122,0.062077785793927,64652,152470,0,7,0,970,12,958,159.9412371134,5541,5111,430,4927,614,27.999097635806,2.6654033567948,0,35,114,83,31
"Sun Mar 4 06:51:02 2012 -0800",129,624,217005,0.062096885313667,64598,152407,0,7,0,970,12,958,159.86907216495,5541,5111,430,4927,614,27.986464537087,2.665222883956,0,35,114,83,31
"Sat Mar 3 18:55:07 2012 -0500",129,624,216806,0.062152645478315,64584,152222,0,7,0,970,12,958,159.6793814433,5539,5109,430,4925,614,27.96335078534,2.6652825419751,0,35,114,83,31
"Wed Feb 29 08:32:45 2012 -0800",129,624,216644,0.062185979218729,64584,152060,0,7,0,968,12,956,159.83884297521,5537,5107,430,4923,614,27.943651797002,2.6649810366625,0,35,114,83,31
"Thu Feb 23 17:11:08 2012 -0800",129,624,216617,0.062270628625548,64571,152046,0,7,0,968,12,956,159.80681818182,5536,5106,430,4924,612,27.943099710983,2.6663656069364,0,35,114,83,31
"Wed Feb 22 22:49:42 2012 +0100",129,624,216616,0.062273905207909,64578,152038,0,7,0,968,12,956,159.79855371901,5536,5106,430,4924,612,27.941654624277,2.6663656069364,0,35,114,83,31
"Tue Feb 21 18:24:16 2012 -0800",129,624,216462,0.062371622689208,64566,151896,0,7,0,968,12,956,159.64566115702,5534,5104,430,4922,612,27.925009035056,2.6680520419227,0,35,114,83,31
"Mon Feb 20 21:23:29 2012 -0500",129,624,216355,0.062377346065196,64505,151850,0,7,0,968,12,956,159.58884297521,5534,5104,430,4948,586,27.915070473437,2.667690639682,0,35,114,83,31
"Sun Feb 19 08:56:55 2012 -0800",128,620,215258,0.062223868356306,64062,151196,0,7,0,963,12,951,159.7528556594,5501,5072,429,4917,584,27.966187965824,2.6660607162334,0,35,111,83,28
"Thu Feb 16 13:07:37 2012 -0800",128,620,215045,0.062255521653087,63958,151087,0,7,0,963,12,951,159.6261682243,5488,5060,428,4904,584,28.010204081633,2.6696428571429,0,35,111,83,28
"Tue Feb 14 23:26:55 2012 +0700",128,620,215030,0.062265000264788,63966,151064,0,7,0,963,12,951,159.60539979232,5489,5061,428,4905,584,28.001457460375,2.6693386773547,0,35,111,83,28
"Sun Feb 12 21:04:35 2012 -0430",126,618,214605,0.062318398322962,63863,150742,0,7,0,958,12,946,160.10334029228,5477,5084,393,4895,582,28.004199379222,2.6708051853204,0,35,111,83,28
"Fri Feb 10 17:26:05 2012 +0100",126,614,212416,0.062719568773633,63260,149156,0,7,0,951,12,939,159.56677181914,5405,5013,392,4824,581,28.075485661425,2.6860314523589,0,35,110,82,28
"Sat Feb 4 11:03:01 2012 -0500",126,613,212121,0.062719009706913,63155,148966,0,7,0,950,12,938,159.53578947368,5400,5008,392,4819,581,28.066481481481,2.6853703703704,0,35,110,82,28
"Mon Jan 30 22:29:52 2012 -0500",126,613,212006,0.062737617045287,63132,148874,0,7,0,950,12,938,159.43368421053,5397,5005,392,4816,581,28.064109690569,2.6857513433389,0,35,110,82,28
"Sat Jan 28 09:12:53 2012 -0800",124,606,211869,0.062768817204301,63069,148800,0,7,0,949,12,937,159.5416227608,5397,5005,392,4816,581,28.053548267556,2.6857513433389,0,35,110,82,28
"Wed Jan 25 12:43:55 2012 +0100",124,606,211702,0.062780842190233,63042,148660,0,7,0,949,12,937,159.38988408851,5393,5001,392,4812,581,28.047654366772,2.6857036899685,0,35,110,82,28
"Sun Jan 22 12:52:00 2012 -0800",122,605,211579,0.062811652523839,62976,148603,0,7,0,948,12,936,159.49578059072,5388,4996,392,4807,581,28.06273199703,2.6870824053452,0,35,111,83,28
"Sun Jan 15 01:03:48 2012 +0100",122,605,209572,0.063079726899328,62520,147052,0,7,0,944,12,932,158.46716101695,5318,4929,389,4742,576,28.129559984957,2.6983828506958,0,35,111,83,28
"Sun Jan 8 20:12:40 2012 -0430",122,604,209215,0.062970782537629,62385,146830,0,7,0,943,12,931,158.4019088017,5306,4923,383,4739,567,28.151715039578,2.6965699208443,0,35,111,83,28
"Thu Dec 29 11:15:37 2011 -0500",122,603,209164,0.062911290652206,62370,146794,0,7,0,943,12,931,158.38388123012,5305,4923,382,4739,566,28.153817153629,2.6957587181904,0,35,111,83,28
"Thu Jan 5 19:56:01 2012 -0430",122,603,208787,0.063013997802393,62264,146523,0,7,0,943,12,931,158.07953340403,5293,4913,380,4728,565,28.163423389382,2.6992253920272,0,35,111,83,28
"Thu Dec 22 03:15:04 2011 +0530",120,598,207221,0.063113132367893,61657,145564,0,6,0,937,12,925,158.02454642476,5233,4854,379,4673,560,28.295241735142,2.7099178291611,0,35,111,83,28
"Sat Dec 17 22:14:58 2011 -0500",120,598,206913,0.063136161866419,61608,145305,0,6,0,937,12,925,157.74279615795,5227,4848,379,4667,560,28.277214463363,2.7093935335757,0,35,111,83,28
"Sat Oct 8 15:14:17 2011 -0400",120,598,206841,0.063162604984166,61581,145260,0,6,0,937,12,925,157.69370330843,5222,4843,379,4663,559,28.295480658751,2.7112217541172,0,35,111,83,28
"Thu Sep 1 20:00:56 2011 +0100",120,597,206484,0.063174145880861,61393,145091,0,6,0,936,12,924,157.66346153846,5206,4827,379,4649,557,28.346715328467,2.7147522089896,0,35,108,83,25
"Mon Dec 5 12:17:28 2011 +0100",120,593,205079,0.063369976072407,60894,144185,0,5,0,929,11,918,157.86329386437,5170,4791,379,4613,557,28.366537717602,2.721083172147,0,35,108,83,25
"Wed Nov 9 09:42:52 2011 -0800",117,578,201730,0.063361346903726,59656,142074,0,5,0,904,11,893,159.92367256637,5106,4731,375,4549,557,28.313944379162,2.7166079122601,0,35,108,83,25
"Sun Oct 23 21:23:06 2011 -0400",117,577,201076,0.063389035639117,59490,141586,0,5,0,903,11,892,159.51495016611,5084,4718,366,4528,556,28.332415420928,2.7193154996066,0,35,107,83,24
"Thu Oct 20 08:57:49 2011 +0200",117,577,200598,0.063415186790155,59370,141228,0,5,0,903,11,892,159.09523809524,5066,4703,363,4514,552,28.358270825109,2.7216739044611,0,35,107,83,24
"Tue Oct 18 12:24:35 2011 +0200",117,576,199222,0.063379529778556,58735,140487,0,4,0,907,10,897,154.58765159868,4942,4583,359,4396,546,28.371307163092,2.7549575070822,0,35,107,83,24
"Tue Oct 18 11:36:30 2011 +0200",117,576,199222,0.063379529778556,58735,140487,0,4,0,907,10,897,154.58765159868,4942,4583,359,4396,546,28.371307163092,2.7549575070822,0,35,107,83,24
"Fri Sep 9 20:40:32 2011 -0400",117,573,198168,0.063427713427713,58308,139860,0,4,0,905,10,895,153.99779005525,4903,4544,359,4363,540,28.425045890271,2.7603508056292,0,35,107,83,24
"Tue Sep 6 02:37:18 2011 +0100",117,573,198018,0.063466162830642,58290,139728,0,4,0,905,10,895,153.86850828729,4900,4541,359,4360,540,28.418571428571,2.760612244898,0,35,107,83,24
"Sat Sep 3 19:12:06 2011 -0430",117,573,198018,0.063466162830642,58290,139728,0,4,0,905,10,895,153.86850828729,4900,4541,359,4360,540,28.418571428571,2.760612244898,0,35,107,83,24
"Sat Sep 3 14:31:02 2011 -0430",117,573,197963,0.063354926452167,58258,139705,0,4,0,904,10,894,154.0453539823,4894,4535,359,4354,540,28.454638332652,2.7613404168369,0,35,107,83,24
"Fri Sep 2 00:19:37 2011 +0200",117,575,199276,0.064478511903069,58640,140636,0,4,0,906,10,896,156.38300220751,4933,4574,359,4389,544,28.721467666734,2.7914048246503,2,35,107,83,24
"Thu Sep 1 00:38:08 2011 +0100",117,575,199175,0.064170514288967,58612,140563,0,4,0,906,10,896,154.6821192053,4929,4570,359,4385,544,28.432136335971,2.783120308379,0,35,107,83,24
"Mon Aug 29 16:54:22 2011 -0430",117,575,198790,0.064362718535208,58538,140252,0,4,0,905,10,895,155.21657458564,4918,4559,359,4374,544,28.562627084181,2.7850752338349,0,35,107,83,24
"Sun Aug 21 09:56:23 2011 -0400",117,575,200674,0.064255136986301,60514,140160,0,4,0,905,10,895,154.35580110497,4899,4541,358,4385,514,28.514390691978,2.7901612573995,0,35,107,83,24
"Fri Aug 19 16:47:46 2011 +0200",117,575,200544,0.065816712590837,60458,140086,0,4,0,906,10,896,154.06622516556,4896,4540,356,4382,514,28.509803921569,2.7930964052288,0,35,107,83,24
"Sun Aug 14 05:09:57 2011 +0530",117,575,200544,0.065816712590837,60458,140086,0,4,0,906,10,896,154.06622516556,4896,4540,356,4382,514,28.509803921569,2.7930964052288,0,35,107,83,24
"Sun Jul 31 06:33:56 2011 +0530",117,575,199655,0.064086471908823,60234,139421,0,4,0,905,9,896,153.73701657459,4876,4521,355,4368,508,28.534044298605,2.788146021329,0,35,120,96,24
"Mon Jul 25 23:29:04 2011 -0430",117,575,199621,0.064203369365225,60485,139136,0,4,0,905,9,896,153.53038674033,4875,4520,355,4366,509,28.501538461538,2.7885128205128,0,35,120,96,24
"Fri Jul 22 20:45:33 2011 -0400",117,574,198193,0.064762621475141,59996,138197,0,4,0,905,9,896,153.77679558011,4840,4483,357,4334,506,28.753719008264,2.8059917355372,0,35,120,96,24
"Fri Jul 15 18:30:55 2011 -0430",117,574,197995,0.064609345577798,59919,138076,0,4,0,905,9,896,152.77127071823,4832,4477,355,4328,504,28.612996688742,2.8023592715232,0,35,120,96,24
"Sat Jul 9 07:45:19 2011 -0700",117,574,198126,0.064707204431265,60197,137929,0,4,0,907,9,898,153.14332965821,4871,4516,355,4364,507,28.515910490659,2.7889550400328,0,35,120,96,24
"Sun Jul 3 12:53:57 2011 -0400",117,574,198126,0.064707204431265,60197,137929,0,4,0,907,9,898,153.14332965821,4871,4516,355,4364,507,28.515910490659,2.7889550400328,0,35,120,96,24
"Tue Jun 28 17:28:36 2011 +0530",117,574,197876,0.064746168061746,59891,137985,0,4,0,906,9,897,152.69867549669,4828,4474,354,4324,504,28.654722452361,2.8071665285833,0,35,120,96,24
"Thu Jun 23 13:53:19 2011 -0700",117,574,197788,0.064705285436781,59824,137964,0,4,0,906,9,897,151.75607064018,4820,4466,354,4314,506,28.52510373444,2.8066390041494,0,35,120,96,24
"Wed Jun 22 13:08:17 2011 -0700",117,573,197618,0.064764959435728,59812,137806,0,4,0,903,9,894,152.16943521595,4815,4461,354,4309,506,28.53769470405,2.8103842159917,0,35,120,96,24
"Wed Jun 22 15:39:33 2011 +0200",117,573,197618,0.064764959435728,59812,137806,0,4,0,903,9,894,152.16943521595,4815,4461,354,4309,506,28.53769470405,2.8103842159917,0,35,120,96,24
"Tue Jun 21 15:30:17 2011 -0430",117,571,197277,0.065008282235332,59633,137644,0,4,0,901,9,892,155.35627081021,4802,4448,354,4294,508,29.149521032903,2.820074968763,0,35,119,96,23
"Mon Jun 20 19:49:06 2011 -0430",117,571,197277,0.065008282235332,59633,137644,0,4,0,901,9,892,155.35627081021,4802,4448,354,4294,508,29.149521032903,2.820074968763,0,35,119,96,23
"Sun Jun 19 18:43:11 2011 -0400",117,571,197277,0.065008282235332,59633,137644,0,4,0,901,9,892,155.35627081021,4802,4448,354,4294,508,29.149521032903,2.820074968763,0,35,119,96,23
"Sun Jun 12 22:42:22 2011 +0200",117,569,196938,0.064905193434509,59553,137385,0,4,0,899,9,890,152.34149054505,4790,4435,355,4283,507,28.591858037578,2.8181628392484,0,35,118,96,22
"Thu Jun 2 21:53:56 2011 -0400",117,569,196938,0.064905193434509,59553,137385,0,4,0,899,9,890,152.34149054505,4790,4435,355,4283,507,28.591858037578,2.8181628392484,0,35,118,96,22
"Mon May 30 21:48:26 2011 -0400",117,569,196822,0.065521211326309,59584,137238,0,4,0,899,9,890,152.18909899889,4788,4433,355,4281,507,28.575187969925,2.8182957393484,0,35,118,96,22
"Sun May 29 00:02:53 2011 +0200",117,569,196822,0.065521211326309,59584,137238,0,4,0,899,9,890,152.18909899889,4788,4433,355,4281,507,28.575187969925,2.8182957393484,0,35,118,96,22
"Thu May 26 16:54:31 2011 +0200",117,569,196862,0.06519760269733,59541,137321,0,4,0,901,9,892,151.94117647059,4788,4434,354,4324,464,28.592105263158,2.8264411027569,0,35,118,96,22
"Tue May 24 09:05:23 2011 +0200",117,569,196881,0.065215650008374,59552,137329,0,4,0,899,9,890,152.23915461624,4789,4435,354,4325,464,28.578617665483,2.8227187304239,0,35,118,96,22
"Sun May 22 23:29:17 2011 +0200",117,569,196881,0.065215650008374,59552,137329,0,4,0,899,9,890,152.23915461624,4789,4435,354,4325,464,28.578617665483,2.8227187304239,0,35,118,96,22
"Thu May 19 14:05:18 2011 -0700",117,569,196923,0.064990021704613,59625,137298,0,4,0,898,9,889,153.96325167038,4796,4441,355,4338,458,28.827981651376,2.8171392827356,0,35,118,96,22
"Tue May 17 21:48:16 2011 +0200",117,569,196923,0.064990021704613,59625,137298,0,4,0,898,9,889,153.96325167038,4796,4441,355,4338,458,28.827981651376,2.8171392827356,0,35,118,96,22
"Sun May 15 16:15:06 2011 +0200",117,569,196883,0.06519803208806,59885,136998,0,4,0,899,9,890,153.70522803115,4835,4480,355,4377,458,28.579317476732,2.8043433298862,0,35,118,96,22
"Tue May 17 00:08:51 2011 +0200",117,569,196862,0.070339310304629,59613,137249,0,4,0,898,9,889,152.46213808463,4795,4440,355,4337,458,28.552867570386,2.969968717414,0,35,118,96,22
"Mon May 16 12:11:27 2011 -0700",117,569,196859,0.065026848620411,59608,137251,0,4,0,898,9,889,152.44097995546,4795,4440,355,4337,458,28.548905109489,2.8179353493222,0,35,118,96,22
"Sun May 15 19:10:53 2011 +0200",117,569,196835,0.065039169247586,59610,137225,0,4,0,899,9,890,152.59844271413,4795,4440,355,4337,458,28.610218978102,2.8179353493222,0,35,118,96,22
"Sun Apr 17 12:28:10 2011 +0200",117,569,196750,0.065064743580386,59748,137002,0,4,0,898,9,889,152.50668151448,4794,4439,355,4336,458,28.567167292449,2.8149770546516,0,35,122,100,22
"Sun Apr 17 12:06:33 2011 +0200",117,569,196800,0.065058730031425,59647,137153,0,4,0,898,9,889,152.22271714922,4794,4439,355,4336,458,28.513975803087,2.8149770546516,0,35,132,110,22
"Thu May 12 22:41:35 2011 -0400",115,558,196129,0.065051943589481,59346,136783,0,4,0,894,9,885,152.47986577181,4763,4415,348,4306,457,28.619987402897,2.8234306109595,0,35,136,114,22
"Sat May 7 19:00:17 2011 +0200",115,558,195999,0.064933163496874,59397,136602,0,4,0,894,9,885,152.36912751678,4763,4415,348,4306,457,28.599202183498,2.8181818181818,0,35,136,114,22
"Wed Apr 27 00:26:42 2011 -0400",115,557,195017,0.065451851851852,60017,135000,0,4,0,892,9,883,152.63004484305,4735,4387,348,4284,451,28.753115100317,2.8217529039071,0,35,133,114,19
"Mon Apr 25 19:22:14 2011 +0200",115,557,195070,0.065434649919475,59087,135983,0,4,0,891,9,882,152.17283950617,4734,4386,348,4295,439,28.6408956485,2.8352344740177,0,35,133,114,19
"Fri Apr 22 17:08:44 2011 -0430",112,550,193031,0.067001277063348,58347,134684,0,4,0,880,8,872,153.24318181818,4663,4320,343,4250,413,28.920008578169,2.890199442419,0,35,128,114,14
"Thu Apr 21 19:01:15 2011 -0430",112,550,193031,0.067001277063348,58347,134684,0,4,0,880,8,872,153.24318181818,4663,4320,343,4250,413,28.920008578169,2.890199442419,0,35,128,114,14
"Tue Apr 19 12:14:02 2011 -0430",112,549,193013,0.065108960275518,58285,134728,0,4,0,879,8,871,152.70762229807,4662,4320,342,4249,413,28.792363792364,2.8307593307593,1,35,128,114,14
"Sun Apr 17 18:03:43 2011 +0200",112,551,193108,0.06495250816266,58348,134760,0,4,0,879,8,871,153.32536973834,4659,4317,342,4248,411,28.927452242971,2.8304357158188,0,39,128,114,14
"Sat Mar 26 22:34:03 2011 +0100",98,545,193133,0.065909276422704,58372,134761,0,4,0,879,7,872,152.93515358362,4671,4328,343,4257,414,28.779704560051,2.8482123742239,0,39,134,120,14
"Sat Mar 19 10:14:10 2011 -0400",98,545,193119,0.065793477050944,58364,134755,0,4,0,879,7,872,152.94311717861,4669,4326,343,4255,414,28.793531805526,2.8455772113943,0,39,134,120,14
"Sat Mar 12 12:19:06 2011 -0500",98,545,192894,0.065733839626077,58321,134573,0,4,0,879,7,872,153.44596131968,4665,4322,343,4251,414,28.912968917471,2.8420150053591,0,39,134,120,14
"Thu Mar 10 03:54:20 2011 +0530",98,545,192910,0.065725222044669,58365,134545,0,4,0,879,7,872,152.83276450512,4665,4322,343,4250,415,28.797427652733,2.8430868167203,0,39,134,120,14
"Thu Mar 3 06:36:02 2011 -0500",98,545,192896,0.066051679701716,58259,134637,0,4,0,879,7,872,153.69397042093,4662,4316,346,4249,413,28.978335478335,2.8549978549979,0,39,134,120,14
"Wed Mar 2 05:46:27 2011 -0500",98,545,192641,0.065845764666493,58236,134405,0,4,0,879,7,872,152.598407281,4655,4310,345,4242,413,28.815037593985,2.8485499462943,0,39,134,120,14
"Wed Feb 23 01:22:23 2011 -0430",98,545,192507,0.06773653051346,58222,134285,0,4,0,879,7,872,152.54721274175,4653,4308,345,4246,407,28.817751987965,2.9024285407264,0,39,134,120,14
"Mon Feb 21 15:45:46 2011 -0300",98,545,192422,0.065957890658759,58200,134222,0,4,0,879,7,872,152.36973833902,4653,4308,345,4247,406,28.784225231034,2.8489146787019,0,39,134,120,14
"Sun Feb 13 15:13:52 2011 -0500",96,531,191813,0.066622946910305,57625,134188,0,4,0,867,5,862,154.45213379469,4602,4262,340,4201,401,29.098218166015,2.8874402433724,0,39,133,120,13
"Sat Feb 12 22:31:51 2011 -0500",96,531,191910,0.066617993265191,57682,134228,0,4,0,867,5,862,154.50865051903,4607,4264,343,4200,407,29.077273713914,2.8869112220534,0,39,133,120,13
"Sat Feb 12 16:08:48 2011 -0500",96,534,192175,0.066820826495599,58115,134060,0,4,0,875,5,870,153.72685714286,4643,4298,345,4230,413,28.970708593582,2.8746500107689,0,39,137,124,13
"Sat Feb 5 15:24:46 2011 -0500",96,532,191946,0.066565290636135,57792,134154,0,4,0,869,5,864,154.89873417722,4612,4267,345,4203,409,29.186253252385,2.8811795316565,0,39,135,122,13
"Fri Feb 4 21:56:24 2011 -0500",96,532,191853,0.066452368344508,57772,134081,0,4,0,869,5,864,154.03912543153,4607,4262,345,4198,409,29.055784675494,2.8803993922292,0,39,135,122,13
"Tue Jan 18 17:51:09 2011 -0800",96,531,191601,0.066353577135007,57667,133934,0,4,0,867,5,862,155.43252595156,4599,4254,345,4191,408,29.302022178735,2.8788867145032,0,39,135,122,13
"Sun Jan 9 00:09:01 2011 -0500",96,531,191206,0.066336767083907,57630,133576,0,4,0,862,5,857,154.80858468677,4586,4241,345,4178,408,29.098342782381,2.8791975577846,0,39,135,122,13
"Sat Jan 1 22:11:28 2011 -0430",96,531,190866,0.066349182540873,57526,133340,0,4,0,862,5,857,154.48143851508,4575,4231,344,4168,407,29.106666666667,2.8806557377049,0,39,135,122,13
"Sun Dec 26 20:16:48 2010 -0500",96,531,189957,0.066563770516488,57137,132820,0,4,0,862,5,857,153.74129930394,4535,4191,344,4130,405,29.222712238148,2.8912899669239,0,39,135,122,13
"Wed Dec 22 22:33:17 2010 -0500",96,531,191090,0.066473923158584,58271,132819,0,4,0,862,5,857,155.03828306265,4535,4191,344,4130,405,29.469239250276,2.8932745314223,0,39,135,122,13
"Tue Dec 21 20:53:39 2010 -0500",96,531,190901,0.066616974980989,58082,132819,0,4,0,862,5,857,154.05452436195,4536,4192,344,4131,405,29.275793650794,2.8910934744268,0,39,135,122,13
"Wed Dec 15 22:12:48 2010 -0500",96,531,191030,0.067640375035743,58136,132894,0,4,0,864,5,859,153.43402777778,4540,4196,344,4136,404,29.199779735683,2.8898678414097,0,40,139,126,13
"Sun Dec 12 21:02:42 2010 -0500",94,520,189137,0.066532151011522,57306,131831,0,4,0,841,5,836,156.37455410226,4483,4157,326,4090,393,29.335489627482,2.9007361142092,0,40,138,125,13
"Sun Dec 12 15:48:36 2010 -0500",94,520,189211,0.066525021815836,57426,131785,0,4,0,842,5,837,156.19833729216,4485,4168,317,4092,393,29.324191750279,2.898773690078,0,40,138,125,13
"Sun Dec 12 12:44:48 2010 -0500",94,520,189096,0.06665553464084,57344,131752,0,4,0,842,5,837,156.24346793349,4483,4167,316,4090,393,29.345750613429,2.9029667633281,0,40,138,125,13
"Fri Dec 10 02:42:38 2010 -0200",94,520,188819,0.066582561312044,57238,131581,0,4,0,834,5,829,158.23860911271,4475,4160,315,4082,393,29.490726256983,2.9012290502793,0,40,138,125,13
"Sat Nov 27 12:09:43 2010 -0800",90,509,188155,0.067689723621927,57175,130980,0,3,0,830,5,825,160.65060240964,4524,4225,299,4138,386,29.47391688771,2.9042882404951,0,40,155,142,13
"Tue Nov 2 23:49:19 2010 -0400",90,506,187577,0.067781683399576,56996,130581,0,3,0,823,5,818,161.55042527339,4505,4207,298,4120,385,29.512985571587,2.9089900110988,0,40,155,142,13
"Sat Oct 30 01:29:26 2010 -0200",86,489,184079,0.068097849336911,55514,128565,0,3,0,804,5,799,162.5460199005,4343,4052,291,3980,363,30.091411466728,2.9491135160028,0,40,166,160,6
"Sun Oct 24 20:57:12 2010 -0400",86,489,184045,0.068118873502412,55505,128540,0,3,0,804,5,799,162.61194029851,4341,4050,291,3978,363,30.117484450587,2.9502418797512,0,40,166,160,6
"Wed Oct 13 23:09:55 2010 -0400",86,489,183886,0.068105186927168,55467,128419,0,3,0,804,5,799,162.36194029851,4336,4045,291,3974,362,30.105857933579,2.9506457564576,0,40,166,160,6
"Sun Oct 3 19:00:27 2010 -0430",86,490,185422,0.068778686811613,56225,129197,0,3,0,809,5,804,162.43634116193,4414,4130,284,4055,359,29.771409152696,2.9476665156321,0,40,167,161,6
"Mon Sep 27 23:40:57 2010 -0430",86,490,185604,0.068702408101736,56249,129355,0,3,0,809,5,804,162.65265760198,4415,4132,283,4057,358,29.804303510759,2.9474518686297,0,40,167,161,6
"Thu Aug 26 23:19:20 2010 -0400",84,477,182727,0.069246595781439,55385,127342,0,3,0,794,5,789,163.13350125945,4317,4006,311,3994,323,30.004169562196,2.9735927727589,0,40,166,166,0
"Wed Aug 11 22:47:20 2010 -0400",84,477,182199,0.06943295109745,55314,126885,0,3,0,794,5,789,162.68513853904,4304,3994,310,3981,323,30.012081784387,2.9776951672862,0,40,166,166,0
"Sat Jul 31 15:41:28 2010 -0400",84,477,182345,0.069396334550951,55321,127024,0,3,0,794,5,789,162.80352644836,4307,3997,310,3984,323,30.013002089622,2.9774785233341,0,40,166,166,0
"Wed Jul 14 23:11:13 2010 -0400",84,477,182376,0.069394919750317,55335,127041,0,3,0,794,5,789,162.83249370277,4312,4002,310,3989,323,29.98353432282,2.9754174397032,0,40,166,166,0
"Tue Jul 6 22:46:08 2010 -0400",83,474,182197,0.069420381162388,55217,126980,0,3,0,789,5,784,163.78833967047,4302,3992,310,3981,321,30.039284053928,2.9800092980009,0,40,166,166,0
"Sun Jul 4 16:56:21 2010 -0400",83,474,182164,0.069425080932914,55207,126957,0,3,0,789,5,784,163.75792141952,4302,3992,310,3982,320,30.033705253371,2.9797768479777,0,40,166,166,0
"Sun Jul 4 00:29:28 2010 -0400",83,471,182020,0.069617360607684,55112,126908,0,3,0,785,5,780,164.53248407643,4291,3981,310,3970,321,30.099743649499,2.9897459799581,0,40,166,166,0
"Sat Jul 3 11:41:49 2010 -0400",83,471,181927,0.069625939879254,55049,126878,0,3,0,783,5,778,164.90804597701,4284,3974,310,3966,318,30.140756302521,2.9927637721755,0,40,166,166,0
"Fri Jul 2 23:15:48 2010 -0400",83,471,181943,0.069701291435866,55030,126913,0,3,0,781,5,776,165.37003841229,4276,3967,309,3956,320,30.204396632367,2.9992984097287,0,40,166,166,0
"Mon Jul 26 22:42:32 2010 -0400",83,468,181548,0.069721194138211,54829,126719,0,3,0,776,4,772,166.17912371134,4256,3948,308,3942,314,30.299577067669,3.0058740601504,0,40,166,166,0
"Sun Jul 25 19:09:29 2010 -0400",83,468,181548,0.069721194138211,54829,126719,0,3,0,776,4,772,166.17912371134,4256,3948,308,3942,314,30.299577067669,3.0058740601504,0,40,166,166,0
"Sun Jul 25 01:15:28 2010 -0400",79,462,181138,0.069806799579277,54689,126449,0,2,0,769,4,765,167.40702210663,4216,3945,271,3904,312,30.535104364326,3.0230075901328,0,40,166,166,0
"Thu Jul 22 11:05:39 2010 +1000",79,462,180990,0.06987417899818,54620,126370,0,2,0,769,4,765,167.22756827048,4208,3941,267,3899,309,30.56036121673,3.027566539924,0,40,166,166,0
"Wed Jul 7 23:33:38 2010 -0400",79,462,180990,0.06987417899818,54620,126370,0,2,0,769,4,765,167.22756827048,4208,3941,267,3899,309,30.56036121673,3.027566539924,0,40,166,166,0
"Sun Jul 4 14:12:28 2010 +1000",79,462,181007,0.069984103509091,54564,126443,0,2,0,769,4,765,167.35760728218,4201,3941,260,3896,305,30.635086884075,3.0354677457748,0,40,166,166,0
"Tue Jun 15 00:18:06 2010 +1000",79,462,181121,0.070052013343241,54615,126506,0,2,0,769,4,765,167.38491547464,4206,3959,247,3900,306,30.603661436044,3.036138849263,0,40,166,166,0
"Thu Jul 15 22:16:19 2010 -0430",79,462,180702,0.069993580751765,54519,126183,0,2,0,768,4,764,167.23828125,4191,3944,247,3886,305,30.646385110952,3.0362681937485,0,40,166,166,0
"Wed Jul 14 17:54:19 2010 -0430",79,462,180604,0.070032431232308,54491,126113,0,2,0,768,4,764,167.06380208333,4187,3940,247,3883,304,30.643658944352,3.038213518032,0,40,166,166,0
"Sat Jul 10 00:48:45 2010 -0400",79,456,179896,0.069960942782369,54183,125713,0,2,0,762,4,758,168.0656167979,4171,3924,247,3870,301,30.703907935747,3.0378806041717,0,40,164,164,0
"Mon Jul 5 22:35:13 2010 -0400",79,456,180048,0.069987911178978,54312,125736,0,2,0,762,4,758,167.8937007874,4171,3953,218,3881,290,30.672500599377,3.0388396068089,0,40,164,164,0
"Wed Jun 30 22:48:30 2010 -0400",79,456,180283,0.070126093485567,54424,125859,0,2,0,762,4,758,168.26640419948,4175,3989,186,3887,288,30.711137724551,3.0431137724551,0,40,166,166,0
"Mon Jun 28 22:31:35 2010 -0400",79,457,180188,0.070184923120955,54406,125782,0,2,0,763,4,759,167.84665792923,4175,3990,185,3886,289,30.674730538922,3.0431137724551,0,40,168,168,0
"Mon Apr 26 21:42:16 2010 -0430",79,457,180188,0.070184923120955,54406,125782,0,2,0,763,4,759,167.84665792923,4175,3990,185,3886,289,30.674730538922,3.0431137724551,0,40,168,168,0
"Fri Apr 23 13:10:56 2010 +1000",78,450,179599,0.071521425324391,54210,125389,0,0,0,755,1,754,168.62251655629,4060,3923,137,3808,252,31.357142857143,3.1334975369458,0,41,170,170,0
"Mon Apr 19 00:15:56 2010 -0400",78,450,179830,0.071442797167143,54303,125527,0,0,0,755,1,754,168.81324503311,4062,3984,78,3808,254,31.377154111275,3.1324470704087,0,41,170,170,0
"Sun Apr 18 00:53:52 2010 -0400",78,452,180037,0.071485438593698,54431,125606,0,0,0,758,1,757,168.30079155673,4071,4002,69,3818,253,31.33677229182,3.1292065831491,0,41,170,170,0
"Fri Apr 16 02:20:15 2010 +1000",78,451,179737,0.071562953396789,54295,125442,0,0,0,755,0,755,168.66092715232,4054,3985,69,3800,254,31.410705476073,3.1378885051801,0,42,169,169,0
"Wed Apr 14 23:27:34 2010 -0400",78,451,179845,0.071585069513604,54330,125515,0,0,0,755,0,755,168.71523178808,4057,4017,40,3816,241,31.397584421987,3.1365541040177,0,42,169,169,0
"Tue Apr 13 23:54:21 2010 -0400",78,455,183750,0.072164868068118,55502,128248,0,0,0,766,0,766,169.76240208877,4140,4140,0,3913,227,31.410144927536,3.1509661835749,0,54,170,170,0
"Fri Apr 9 21:17:55 2010 +1000",78,455,183620,0.072195829725492,55427,128193,0,0,0,764,0,764,170.13612565445,4135,4135,0,3906,229,31.435066505441,3.1535671100363,0,54,170,170,0
"Mon Apr 5 16:43:47 2010 +1000",78,455,183267,0.072231590781338,55179,128088,0,0,0,764,0,764,169.98821989529,4133,4133,0,3905,228,31.422937333656,3.1538833776917,0,54,170,170,0
"Sun Apr 4 18:17:43 2010 +1000",78,457,184872,0.072291224566221,56696,128176,0,0,0,765,0,765,169.88104575163,4140,4140,0,4057,83,31.391062801932,3.1533816425121,0,54,170,170,0
"Fri Apr 2 13:55:05 2010 -0400",78,457,184807,0.072318306693307,56679,128128,0,0,0,764,0,764,170.03272251309,4136,4136,0,4136,0,31.4083655706,3.1554642166344,0,54,170,170,0
"Mon Mar 29 23:50:40 2010 -0430",78,457,184807,0.072318306693307,56679,128128,0,0,0,764,0,764,170.03272251309,4136,4136,0,4136,0,31.4083655706,3.1554642166344,0,54,170,170,0
"Sun Mar 28 11:28:03 2010 -0400",78,457,184704,0.072336571196552,56636,128068,0,0,0,764,0,764,169.95418848168,4133,4133,0,4133,0,31.41664650375,3.1565448826518,0,54,170,170,0
"Fri Mar 26 20:36:04 2010 +1100",78,457,184511,0.07240745807763,56596,127915,0,0,0,763,0,763,169.97247706422,4127,4127,0,4127,0,31.424521444148,3.1591955415556,0,54,170,170,0
"Tue Mar 23 00:39:24 2010 +0530",77,456,184257,0.072441191436064,56512,127745,0,0,0,761,0,761,170.18134034166,4122,4122,0,4122,0,31.418728772441,3.1598738476468,0,54,170,170,0
"Fri Mar 19 20:44:18 2010 -0400",77,456,184199,0.072411795104687,56485,127714,0,0,0,761,0,761,170.14191852825,4122,4122,0,4122,0,31.411450752062,3.1589034449296,0,54,170,170,0
"Tue Mar 16 16:49:57 2010 -0430",77,456,184164,0.072427106909866,56477,127687,0,0,0,761,0,761,170.18134034166,4121,4121,0,4121,0,31.426352826984,3.1594273234652,0,54,170,170,0
"Sun Mar 14 16:06:31 2010 -0400",77,456,184022,0.072453202897187,56450,127572,0,0,0,761,0,761,169.99474375821,4120,4120,0,4120,0,31.399514563107,3.1584951456311,0,54,171,171,0
"Fri Mar 12 23:03:06 2010 -0500",77,456,183804,0.07247639454661,56397,127407,0,0,0,761,0,761,169.71090670171,4114,4114,0,4114,0,31.392805055907,3.1594555177443,0,54,171,171,0
"Mon Mar 8 22:48:39 2010 -0500",77,456,183710,0.072458645553513,56396,127314,0,0,0,761,0,761,169.58869908016,4111,4111,0,4111,0,31.393091705181,3.1588421308684,0,54,171,171,0
"Sun Feb 28 13:51:47 2010 -0500",77,455,183493,0.072533400435641,56324,127169,0,0,0,760,0,760,169.37105263158,4097,4097,0,4097,0,31.41859897486,3.1659751037344,0,54,171,171,0
"Sun Feb 28 11:39:09 2010 -0500",77,455,183445,0.072548233091873,56302,127143,0,0,0,760,0,760,169.25921052632,4093,4093,0,4093,0,31.428536525776,3.1680918641583,0,54,171,171,0
"Sat Feb 27 23:18:21 2010 -0430",77,455,183295,0.072637567573948,56212,127083,0,0,0,760,0,760,169.17894736842,4085,4085,0,4085,0,31.475152998776,3.1740514075887,0,54,170,170,0
"Sat Feb 20 11:42:17 2010 -0500",77,455,183127,0.072671556077233,56186,126941,0,0,0,760,0,760,169.00921052632,4080,4080,0,4080,0,31.482107843137,3.1754901960784,0,54,170,170,0
"Mon Feb 15 12:11:05 2010 -0500",74,452,182933,0.072762121104564,56150,126783,0,0,0,757,0,757,169.50066050198,4074,4074,0,4074,0,31.495336278841,3.1786941580756,0,54,170,170,0
"Fri Feb 12 23:51:02 2010 -0500",74,452,182738,0.072879415827906,56063,126675,0,0,0,755,0,755,169.78410596026,4070,4070,0,4070,0,31.495577395577,3.1825552825553,0,54,170,170,0
"Sun Feb 7 16:45:36 2010 -0500",74,452,182655,0.072824352716301,56049,126606,0,0,0,755,0,755,169.65430463576,4068,4068,0,4068,0,31.486971484759,3.1806784660767,0,54,170,170,0
"Sun Jan 31 21:23:32 2010 -0200",74,452,182157,0.072949604938859,55974,126183,0,0,0,755,0,755,169.4582781457,4057,4057,0,4057,0,31.535863938871,3.1828937638649,0,54,170,170,0
"Thu Jan 28 10:55:41 2010 -0500",74,452,182063,0.073057984919005,55944,126119,0,0,0,755,0,755,169.41456953642,4054,4054,0,4054,0,31.551060680809,3.1857424765664,0,54,170,170,0
"Mon Jan 25 17:59:05 2010 -0500",73,447,181665,0.073046279837481,55649,126016,0,0,0,748,0,748,170.43582887701,4051,4051,0,4051,0,31.470254258208,3.1861268822513,0,54,170,170,0
"Fri Jan 22 17:54:28 2010 -0500",73,447,181193,0.073009569947981,55278,125915,0,0,0,748,0,748,170.5320855615,4049,4049,0,4049,0,31.503581131143,3.1842430229686,0,54,170,170,0
"Thu Jan 21 01:42:54 2010 +0530",73,447,180970,0.073079002607977,55202,125768,0,0,0,748,0,748,170.13903743316,4045,4045,0,4045,0,31.462051915946,3.1846724351051,0,54,170,170,0
"Tue Jan 19 09:22:13 2010 -0500",73,447,181041,0.072989684167024,55215,125826,0,0,0,748,0,748,170.43449197861,4046,4046,0,4046,0,31.508897676718,3.1838853188334,0,54,170,170,0
"Sat Jan 16 20:38:08 2010 -0500",73,447,180975,0.072982428242029,55205,125770,0,0,0,748,0,748,170.45855614973,4044,4044,0,4044,0,31.528931750742,3.1837289812067,0,54,170,170,0
"Sat Jan 16 18:15:38 2010 -0500",73,447,180951,0.073387783017743,55208,125743,0,0,0,748,0,748,170.25935828877,4046,4046,0,4046,0,31.476520019773,3.1940187839842,0,54,170,170,0
"Fri Jan 15 00:02:24 2010 -0500",73,448,180909,0.073447856080076,55228,125681,0,0,0,748,0,748,169.98395721925,4041,4041,0,4041,0,31.464488987874,3.1890621133383,0,54,171,171,0
"Thu Jan 14 22:54:17 2010 -0500",73,448,180902,0.073022263952767,55228,125674,0,0,0,748,0,748,170.01737967914,4040,4040,0,4040,0,31.478465346535,3.1846534653465,0,54,171,171,0
"Thu Jan 14 15:50:27 2010 -0430",73,448,180902,0.073022263952767,55228,125674,0,0,0,748,0,748,170.01737967914,4040,4040,0,4040,0,31.478465346535,3.1846534653465,0,54,171,171,0
"Mon Jan 11 12:06:27 2010 -0430",73,448,180902,0.073022263952767,55228,125674,0,0,0,748,0,748,170.01737967914,4040,4040,0,4040,0,31.478465346535,3.1846534653465,0,54,171,171,0
"Wed Jan 6 21:27:14 2010 -0500",73,448,180902,0.073022263952767,55228,125674,0,0,0,748,0,748,170.01737967914,4040,4040,0,4040,0,31.478465346535,3.1846534653465,0,54,171,171,0
"Mon Dec 28 10:20:11 2009 -0500",71,446,179864,0.073298512945837,54650,125214,0,0,0,749,0,749,168.62750333778,3987,3987,0,3987,0,31.678454978681,3.1981439678957,0,62,184,184,0
"Mon Dec 21 09:29:28 2009 -0500",71,446,178588,0.073201132233266,54232,124356,0,0,0,749,0,749,167.61281708945,3957,3957,0,3957,0,31.726560525651,3.195855446045,0,62,184,184,0
"Sun Dec 13 10:36:51 2009 -0500",71,445,178407,0.073277354222183,54194,124213,0,0,0,748,0,748,167.46256684492,3950,3950,0,3950,0,31.711898734177,3.1992405063291,0,62,184,184,0
"Tue Dec 8 23:07:43 2009 -0500",71,451,181171,0.07418734708144,55287,125884,0,0,0,757,0,757,167.87318361955,4053,4053,0,4053,0,31.354552183568,3.2018258080434,0,62,184,184,0
"Sun Dec 6 21:46:05 2009 -0500",71,451,181229,0.074776847922158,55642,125587,0,0,0,755,0,755,167.85430463576,4033,4033,0,4033,0,31.423258120506,3.2253905281428,0,62,187,187,0
"Thu Nov 26 09:52:15 2009 -0500",71,451,181071,0.07513888778186,55610,125461,0,0,0,755,0,755,167.70463576159,4027,4027,0,4027,0,31.442016389372,3.2376458902409,0,62,187,187,0
"Wed Nov 25 01:51:25 2009 -0600",71,451,180946,0.075180522717107,55754,125192,0,0,0,758,0,758,167.10686015831,4038,4038,0,4038,0,31.368746904408,3.2278355621595,0,62,188,188,0
"Fri Nov 13 00:43:40 2009 -0500",68,447,180097,0.075290841881231,55115,124982,0,0,0,754,0,754,167.7175066313,4022,4022,0,4022,0,31.441819990055,3.2364495275982,0,61,189,189,0
"Mon Nov 9 14:07:19 2009 -0500",68,447,180097,0.075290841881231,55115,124982,0,0,0,754,0,754,167.7175066313,4022,4022,0,4022,0,31.441819990055,3.2364495275982,0,61,189,189,0
"Tue Nov 3 23:16:40 2009 -0500",64,443,181124,0.075138210079321,56314,124810,0,0,0,746,0,746,168.36863270777,3979,3979,0,3979,0,31.566473988439,3.2525760241267,0,61,188,188,0
"Sun Nov 1 12:25:40 2009 -0500",64,443,181048,0.075163136714178,56306,124742,0,0,0,746,0,746,168.2654155496,3979,3979,0,3979,0,31.547122392561,3.2518220658457,0,61,188,188,0
"Sat Oct 31 01:45:17 2009 -0400",64,443,180785,0.075436383937537,56296,124489,0,0,0,747,0,747,168.03614457831,3968,3968,0,3968,0,31.633820564516,3.2620967741935,0,61,189,189,0
"Fri Oct 30 00:02:33 2009 -0430",64,443,180595,0.07549384552303,56214,124381,0,0,0,746,0,746,167.94638069705,3959,3959,0,3959,0,31.64637534731,3.266986612781,0,61,188,188,0
"Wed Oct 28 09:21:42 2009 -0400",64,443,180455,0.075774888152177,56179,124276,0,0,0,746,0,746,167.76273458445,3956,3956,0,3956,0,31.635743174924,3.2755308392315,0,61,188,188,0
"Wed Oct 21 20:08:00 2009 -0430",63,442,180378,0.075715619667064,56150,124228,0,0,0,745,0,745,168.17852348993,3954,3954,0,3954,0,31.687658067779,3.2738998482549,0,61,188,188,0
"Mon Oct 19 23:44:50 2009 -0400",62,441,180149,0.075993648388319,56086,124063,0,0,0,744,0,744,167.92338709677,3950,3950,0,3950,0,31.629113924051,3.2817721518987,0,61,187,187,0
"Fri Oct 16 23:00:31 2009 -0400",62,441,180149,0.075993648388319,56086,124063,0,0,0,744,0,744,167.92338709677,3950,3950,0,3950,0,31.629113924051,3.2817721518987,0,61,187,187,0
"Wed Oct 14 21:27:42 2009 -0400",62,441,180023,0.075920072251072,56011,124012,0,0,0,744,0,744,168.26747311828,3947,3947,0,3947,0,31.718013681277,3.2802128198632,0,61,187,187,0
"Tue Oct 13 00:33:14 2009 -0400",62,441,180023,0.075920072251072,56011,124012,0,0,0,744,0,744,168.26747311828,3947,3947,0,3947,0,31.718013681277,3.2802128198632,0,61,187,187,0
"Wed Sep 30 10:19:43 2009 -0400",61,438,178967,0.076020163810668,55776,123191,0,0,0,740,0,740,167.84459459459,3908,3908,0,3908,0,31.782241555783,3.2904298874104,0,61,191,191,0
"Wed Sep 23 10:46:18 2009 -0430",60,436,178495,0.076450484172837,55605,122890,0,0,0,738,0,738,167.52032520325,3880,3880,0,3880,0,31.863402061856,3.3144329896907,0,61,191,191,0
"Sun Sep 20 17:53:23 2009 -0400",60,436,178432,0.07646910384462,55585,122847,0,0,0,738,0,738,167.90785907859,3876,3876,0,3876,0,31.970072239422,3.3165634674923,0,61,191,191,0
"Wed Sep 16 01:23:49 2009 -0400",60,435,178093,0.076547257838243,55489,122604,0,0,0,737,0,737,167.34192672999,3867,3867,0,3867,0,31.893198862167,3.3196276183088,0,61,191,191,0
"Sun Sep 13 14:03:16 2009 -0400",62,435,177650,0.076770735300135,55455,122195,0,0,0,732,0,732,168.01366120219,3858,3858,0,3858,0,31.878175220321,3.3208916537066,0,61,194,194,0
"Fri Aug 14 12:32:54 2009 -0400",62,435,177003,0.076837086963669,55343,121660,0,0,0,731,0,731,167.34062927497,3838,3838,0,3838,0,31.872329338197,3.3246482542991,0,61,194,194,0
"Wed Aug 5 20:45:54 2009 -0400",62,434,176610,0.077059337255096,55236,121374,0,0,0,730,0,730,167.19452054795,3821,3821,0,3821,0,31.942423449359,3.3370845328448,0,61,193,193,0
"Sun Aug 2 20:13:22 2009 -0700",62,434,176610,0.077059337255096,55236,121374,0,0,0,730,0,730,167.19452054795,3821,3821,0,3821,0,31.942423449359,3.3370845328448,0,61,193,193,0
"Sun Jul 26 11:59:51 2009 +0200",62,427,173055,0.077461063767264,53950,119105,0,0,0,722,0,722,165.95844875346,3707,3707,0,3707,0,32.323172376585,3.3746965200971,0,61,194,194,0
"Sun Aug 2 22:44:28 2009 +0200",62,427,173055,0.077461063767264,53950,119105,0,0,0,722,0,722,165.95844875346,3707,3707,0,3707,0,32.323172376585,3.3746965200971,0,61,194,194,0
"Wed Jul 29 09:32:30 2009 +0200",62,427,171339,0.07852011616256,53573,117766,0,0,0,720,0,720,164.30972222222,3672,3672,0,3672,0,32.217592592593,3.4046840958606,0,61,190,190,0
"Tue Jul 28 08:20:50 2009 +0200",62,427,171289,0.078205694482196,53561,117728,0,0,0,720,0,720,164.22083333333,3670,3670,0,3670,0,32.217711171662,3.3950953678474,0,61,190,190,0
"Mon Jul 20 00:20:58 2009 -0400",62,421,163542,0.083353723187342,53193,110349,0,0,0,710,0,710,157.68309859155,3649,3649,0,3649,0,30.681008495478,3.4061386681283,0,61,190,190,0
"Wed Jul 15 10:14:16 2009 -0400",62,420,163501,0.083247212401414,53191,110310,0,0,0,707,0,707,158.54314002829,3636,3636,0,3636,0,30.827832783278,3.4114411441144,0,61,189,189,0
"Wed Jul 1 23:48:51 2009 -0400",62,417,154833,0.089122374509631,52614,102219,0,0,0,694,0,694,149.62680115274,3560,3560,0,3560,0,29.168820224719,3.4435393258427,0,62,185,185,0
"Tue Jun 30 20:49:58 2009 -0400",62,417,154833,0.089122374509631,52614,102219,0,0,0,694,0,694,149.62680115274,3560,3560,0,3560,0,29.168820224719,3.4435393258427,0,62,185,185,0
"Wed Jun 10 22:52:38 2009 -0400",62,415,154355,0.089300435755506,52463,101892,0,0,0,692,0,692,149.60404624277,3544,3544,0,3544,0,29.211625282167,3.4517494356659,0,62,184,184,0
"Sat Jun 6 21:03:26 2009 -0400",62,414,154133,0.089567520206346,52556,101577,0,0,0,694,0,694,149.1757925072,3548,3548,0,3548,0,29.179255918828,3.4489853438557,0,62,183,183,0
"Thu Jun 4 23:35:36 2009 -0400",62,414,154127,0.089794113311385,52372,101755,0,0,0,691,0,691,149.64688856729,3532,3532,0,3532,0,29.276896942242,3.4711211778029,0,62,183,183,0
"Sat May 30 00:14:57 2009 -0400",62,413,153765,0.090111839188057,52280,101485,0,0,0,687,0,687,150.1673944687,3518,3518,0,3518,0,29.324900511654,3.4840818646958,0,62,182,182,0
"Sun May 24 01:30:04 2009 -0400",62,413,153434,0.0899387835703,52154,101280,0,0,0,688,0,688,149.62209302326,3498,3498,0,3498,0,29.428244711264,3.4879931389365,0,62,182,182,0
"Wed May 20 00:31:59 2009 -0400",62,412,153061,0.090051568330512,52030,101031,0,0,0,680,0,680,151.03823529412,3481,3481,0,3481,0,29.504740017236,3.4978454467107,0,62,181,181,0
"Sat May 16 23:17:40 2009 -0400",62,412,153032,0.090204655213364,51984,101048,0,0,0,679,0,679,151.28424153166,3475,3475,0,3475,0,29.560287769784,3.5073381294964,0,62,180,180,0
"Thu May 14 22:23:36 2009 -0400",62,411,152755,0.090519847366074,51860,100895,0,0,0,678,0,678,151.47197640118,3460,3460,0,3460,0,29.681502890173,3.5239884393064,0,62,179,179,0
"Tue May 12 21:26:37 2009 -0400",62,410,152636,0.090806330067822,51784,100852,0,0,0,677,0,677,151.50073855244,3451,3451,0,3451,0,29.720660678064,3.5381048971313,0,62,178,178,0
"Sat May 9 23:32:22 2009 -0400",62,409,152374,0.090863947402397,51685,100689,0,0,0,676,0,676,151.45710059172,3440,3440,0,3440,0,29.763081395349,3.5436046511628,0,62,178,178,0
"Tue May 5 00:10:24 2009 -0400",62,409,151973,0.091184350753479,51572,100401,0,0,0,676,0,676,151.34763313609,3421,3421,0,3421,0,29.906752411576,3.5594855305466,0,62,178,178,0
"Wed Apr 29 21:18:08 2009 -0400",62,409,151973,0.091184350753479,51572,100401,0,0,0,676,0,676,151.34763313609,3421,3421,0,3421,0,29.906752411576,3.5594855305466,0,62,178,178,0
"Mon Apr 27 23:15:28 2009 -0400",62,406,151257,0.091199151821883,51278,99979,0,0,0,673,0,673,151.09212481426,3393,3393,0,3393,0,29.969053934571,3.571470674919,0,62,176,176,0
"Mon Jan 26 23:17:58 2009 -0500",60,395,147634,0.092921941468915,50079,97555,0,0,0,656,0,656,151.32012195122,3320,3320,0,3320,0,29.899397590361,3.6159638554217,0,62,170,170,0
"Thu Jan 15 01:55:31 2009 +0000",60,397,147907,0.093178258065177,50234,97673,0,0,0,658,0,658,151.03039513678,3324,3324,0,3324,0,29.897111913357,3.6233453670277,0,62,170,170,0
"Wed Jan 14 22:08:11 2009 +0000",60,396,147536,0.093397795159204,50114,97422,0,0,0,655,0,655,151.51603053435,3316,3316,0,3316,0,29.928528347407,3.6290711700844,0,62,170,170,0
"Wed Jan 14 05:21:26 2009 +0000",60,396,147471,0.093418498854989,50092,97379,0,0,0,655,0,655,151.23816793893,3314,3314,0,3314,0,29.891671695836,3.6300543150272,0,62,170,170,0
"Fri Jan 2 22:47:38 2009 +0000",60,396,147438,0.093511509187834,50081,97357,0,0,0,655,0,655,151.19694656489,3312,3312,0,3312,0,29.901570048309,3.6328502415459,0,62,170,170,0
"Thu Dec 25 22:11:06 2008 +0000",60,396,147032,0.093807682392369,50057,96975,0,0,0,649,0,649,152.02311248074,3315,3315,0,3315,0,29.762594268477,3.6292609351433,0,62,170,170,0
"Sun Dec 21 22:14:48 2008 +0000",60,393,146750,0.093894871609553,49897,96853,0,0,0,646,0,646,152.5479876161,3312,3312,0,3312,0,29.75422705314,3.6307367149758,0,62,170,170,0
"Thu Dec 18 00:22:57 2008 +0000",60,393,146736,0.093922309646242,49890,96846,0,0,0,646,0,646,152.53715170279,3311,3311,0,3311,0,29.761099365751,3.6321353065539,0,62,170,170,0
"Wed Dec 17 04:14:34 2008 +0000",60,393,146652,0.094015150732216,49891,96761,0,0,0,646,0,646,152.41950464396,3311,3311,0,3311,0,29.738145575355,3.6324373301117,0,62,170,170,0
"Fri Dec 12 17:19:27 2008 +0000",60,393,146652,0.094015150732216,49891,96761,0,0,0,646,0,646,152.41950464396,3311,3311,0,3311,0,29.738145575355,3.6324373301117,0,62,170,170,0
"Mon Dec 8 03:13:45 2008 +0000",60,391,145492,0.094255490230887,49731,95761,0,0,0,639,0,639,152.97026604069,3297,3297,0,3297,0,29.647558386412,3.6211707612981,0,62,173,173,0
"Wed Nov 26 22:33:21 2008 +0000",60,391,145374,0.094348498787321,49718,95656,0,0,0,638,0,638,152.91379310345,3296,3296,0,3296,0,29.599211165049,3.6216626213592,0,62,173,173,0
"Mon Nov 24 05:23:31 2008 +0000",60,391,144420,0.095327576378186,49694,94726,0,0,0,638,0,638,151.74764890282,3290,3290,0,3290,0,29.427051671733,3.6279635258359,0,62,173,173,0
"Fri Nov 14 20:24:27 2008 +0000",60,390,144112,0.095636536732427,49577,94535,0,0,0,633,0,633,152.50236966825,3288,3288,0,3288,0,29.359489051095,3.6329075425791,0,62,173,173,0
"Tue Nov 11 19:52:41 2008 +0000",57,386,143532,0.09575100282276,49298,94234,0,0,0,625,0,625,153.7696,3270,3270,0,3270,0,29.390214067278,3.6418960244648,0,62,173,173,0
"Sun Nov 9 20:55:51 2008 +0000",57,386,143492,0.095829928146128,49273,94219,0,0,0,625,0,625,153.8512,3267,3267,0,3267,0,29.432812978268,3.6461585552495,0,62,173,173,0
"Sat Nov 8 00:55:36 2008 +0000",57,385,143296,0.09580781112326,49097,94199,0,0,0,620,0,620,154.8564516129,3265,3265,0,3265,0,29.406125574273,3.6465543644717,0,62,173,173,0
"Thu Nov 6 23:35:08 2008 +0000",56,384,143165,0.095997196231906,49006,94159,0,0,0,619,0,619,155.04200323102,3256,3256,0,3256,0,29.475122850123,3.6584766584767,0,62,173,173,0
"Wed Nov 5 02:30:51 2008 +0000",56,384,143165,0.095997196231906,49006,94159,0,0,0,619,0,619,155.04200323102,3256,3256,0,3256,0,29.475122850123,3.6584766584767,0,62,173,173,0
"Fri Oct 31 20:17:26 2008 +0000",56,384,143165,0.095997196231906,49006,94159,0,0,0,619,0,619,155.04200323102,3256,3256,0,3256,0,29.475122850123,3.6584766584767,0,62,173,173,0
"Thu Oct 30 17:30:26 2008 +0000",56,384,143165,0.095997196231906,49006,94159,0,0,0,619,0,619,155.04200323102,3256,3256,0,3256,0,29.475122850123,3.6584766584767,0,62,173,173,0
"Wed Oct 29 07:19:26 2008 +0000",56,381,142818,0.096528646417995,49281,93537,0,0,0,612,0,612,155.81535947712,3244,3244,0,3244,0,29.395499383477,3.6658446362515,0,62,172,172,0
"Sun Oct 26 23:47:00 2008 +0000",56,381,142680,0.096636406457414,49268,93412,0,0,0,612,0,612,155.60947712418,3243,3243,0,3243,0,29.36571076164,3.6660499537465,0,62,172,172,0
"Thu Oct 23 13:29:32 2008 +0000",56,378,142387,0.096696039964838,49105,93282,0,0,0,609,0,609,156.15435139573,3242,3242,0,3242,0,29.333127698951,3.664713140037,0,62,172,172,0
"Mon Oct 20 03:01:01 2008 +0000",56,378,142187,0.096667203348897,49022,93165,0,0,0,606,0,606,156.73432343234,3236,3236,0,3236,0,29.351359703337,3.6653275648949,0,62,172,172,0
"Thu Oct 16 05:16:00 2008 +0000",56,377,142021,0.09675894085282,48965,93056,0,0,0,605,0,605,156.79669421488,3232,3232,0,3232,0,29.350866336634,3.6680074257426,0,62,172,172,0
"Wed Oct 15 12:42:03 2008 +0000",56,377,142021,0.09675894085282,48965,93056,0,0,0,605,0,605,156.79669421488,3232,3232,0,3232,0,29.350866336634,3.6680074257426,0,62,172,172,0
"Sun Oct 12 02:36:39 2008 +0000",56,377,141353,0.097166998011928,48801,92552,0,0,0,604,0,604,156.27649006623,3212,3212,0,3212,0,29.38698630137,3.681195516812,0,62,172,172,0
"Fri Oct 10 00:39:01 2008 +0000",55,375,141271,0.097178107646766,48709,92562,0,0,0,601,0,601,157.02495840266,3207,3207,0,3207,0,29.426878702838,3.6866230121609,0,62,171,171,0
"Wed Oct 8 17:53:48 2008 +0000",55,375,140714,0.097473277135657,48658,92056,0,0,0,599,0,599,156.90984974958,3213,3213,0,3213,0,29.252723311547,3.6747587924059,0,62,171,171,0
"Sun Oct 5 22:26:40 2008 +0000",55,375,140494,0.097544516522269,48618,91876,0,0,0,599,0,599,156.39565943239,3208,3208,0,3208,0,29.202306733167,3.6754987531172,0,62,170,170,0
"Thu Oct 2 16:25:35 2008 +0000",55,375,140494,0.097544516522269,48618,91876,0,0,0,599,0,599,156.39565943239,3208,3208,0,3208,0,29.202306733167,3.6754987531172,0,62,170,170,0
"Tue Sep 30 18:59:17 2008 +0000",55,375,139915,0.09795489610347,48526,91389,0,0,0,599,0,599,155.57095158598,3196,3196,0,3196,0,29.157384230288,3.6827284105131,0,61,170,170,0
"Sat Sep 27 14:56:32 2008 +0000",55,374,139763,0.098068220417913,48500,91263,0,0,0,598,0,598,155.70735785953,3194,3194,0,3194,0,29.152473387602,3.6844082654978,0,61,170,170,0
"Thu Sep 25 16:49:56 2008 +0000",55,374,139331,0.098276885206268,48333,90998,0,0,0,594,0,594,156.3569023569,3188,3188,0,3188,0,29.132998745295,3.6875784190715,0,61,170,170,0
"Wed Sep 24 02:00:57 2008 +0000",55,372,138958,0.098892648415872,47930,91028,0,0,0,590,0,590,157.38305084746,3184,3184,0,3184,0,29.163316582915,3.7094849246231,0,61,170,170,0
"Mon Sep 22 04:10:49 2008 +0000",55,370,138579,0.098817232721026,47775,90804,0,0,0,586,0,586,158.26279863481,3180,3180,0,3180,0,29.164150943396,3.7037735849057,0,61,170,170,0
"Fri Sep 19 02:57:58 2008 +0000",54,369,138344,0.098913223368456,47709,90635,0,0,0,585,0,585,158.04786324786,3177,3177,0,3177,0,29.102297765187,3.7038086244885,0,61,170,170,0
"Thu Sep 18 01:54:31 2008 +0000",52,367,138111,0.099098203036934,47625,90486,0,0,0,583,0,583,158.35334476844,3173,3173,0,3173,0,29.095493224078,3.7078474629688,0,61,170,170,0
"Tue Sep 16 01:39:20 2008 +0000",52,367,137969,0.099207754271045,47593,90376,0,0,0,583,0,583,158.14408233276,3170,3170,0,3170,0,29.084542586751,3.710094637224,0,61,170,170,0
"Sun Sep 14 05:00:05 2008 +0000",52,367,137957,0.099225406661503,47587,90370,0,0,0,583,0,583,158.13550600343,3170,3170,0,3170,0,29.082965299685,3.7104100946372,0,61,170,170,0
"Wed Sep 10 16:48:43 2008 +0000",52,367,137952,0.09917556576108,47587,90365,0,0,0,583,0,583,158.12864493997,3170,3170,0,3170,0,29.081703470032,3.7091482649842,0,61,170,170,0
"Tue Sep 9 05:41:56 2008 +0000",52,366,137724,0.099250770287944,47498,90226,0,0,0,581,0,581,158.4165232358,3165,3165,0,3165,0,29.080568720379,3.7112164296998,0,61,170,170,0
"Mon Sep 8 16:58:39 2008 +0000",52,366,137731,0.099264053910268,47507,90224,0,0,0,581,0,581,158.52151462995,3164,3164,0,3164,0,29.109039190898,3.712389380531,0,61,170,170,0
"Fri Sep 5 21:44:30 2008 +0000",52,366,137636,0.09936007630286,47469,90167,0,0,0,580,0,580,158.63103448276,3161,3161,0,3161,0,29.106611831699,3.7155963302752,0,61,170,170,0
"Thu Sep 4 02:04:44 2008 +0000",52,366,137336,0.099585108394603,47433,89903,0,0,0,578,0,578,158.74221453287,3156,3156,0,3156,0,29.072560202788,3.7179974651458,0,61,170,170,0
"Mon Sep 1 14:21:57 2008 +0000",52,366,137168,0.099720275044299,47437,89731,0,0,0,578,0,578,158.36505190311,3155,3155,0,3155,0,29.012678288431,3.7172741679873,0,61,170,170,0
"Thu Aug 28 02:37:37 2008 +0000",52,364,136531,0.0999988800663,47240,89291,0,0,0,573,0,573,158.97382198953,3142,3142,0,3142,0,28.991725015913,3.7224697644812,0,61,170,170,0
"Wed Aug 27 04:55:15 2008 +0000",52,364,136389,0.099880094579603,47152,89237,0,0,0,573,0,573,158.84642233857,3141,3141,0,3141,0,28.977714103789,3.7182425978988,0,61,170,170,0
"Tue Aug 26 16:41:41 2008 +0000",52,362,135956,0.1000629397352,46982,88974,0,0,0,570,0,570,159.23157894737,3131,3131,0,3131,0,28.988182689237,3.7240498243373,0,61,170,170,0
"Mon Aug 25 18:29:22 2008 +0000",52,362,135886,0.10021592928316,46968,88918,0,0,0,570,0,570,159.12807017544,3127,3127,0,3127,0,29.00639590662,3.730092740646,0,61,170,170,0
"Fri Aug 22 19:17:48 2008 +0000",52,360,135330,0.10079314864193,46822,88508,0,0,0,567,0,567,159.25220458554,3111,3111,0,3111,0,29.02475088396,3.7473481195757,0,61,170,170,0
"Tue Aug 19 01:34:44 2008 +0000",52,360,135254,0.10077098736123,46796,88458,0,0,0,567,0,567,159.15873015873,3110,3110,0,3110,0,29.017041800643,3.7459807073955,0,61,170,170,0
"Fri Aug 15 01:12:31 2008 +0000",52,360,135260,0.10078001356545,46800,88460,0,0,0,567,0,567,159.16225749559,3110,3110,0,3110,0,29.01768488746,3.7466237942122,0,61,170,170,0
"Tue Aug 12 23:47:00 2008 +0000",52,360,135214,0.10084375777592,46800,88414,0,0,0,567,0,567,159.08289241623,3110,3110,0,3110,0,29.003215434084,3.7469453376206,0,61,170,170,0
"Sat Aug 9 18:32:59 2008 +0000",52,360,135051,0.10097874847071,46775,88276,0,0,0,567,0,567,158.82892416226,3106,3106,0,3106,0,28.994204764971,3.7498390212492,0,61,170,170,0
"Wed Aug 6 14:13:01 2008 +0000",52,360,134942,0.10102980538039,46770,88172,0,0,0,568,0,568,158.34154929577,3105,3105,0,3105,0,28.965539452496,3.7484702093398,0,61,171,171,0
"Sun Aug 3 17:41:05 2008 +0000",52,360,134766,0.10120353217943,46775,87991,0,0,0,568,0,568,158.01936619718,3106,3106,0,3106,0,28.897295556986,3.7466194462331,0,61,171,171,0
"Sat Aug 2 14:26:50 2008 +0000",52,360,134716,0.10124107832886,46728,87988,0,0,0,567,0,567,158.28924162257,3105,3105,0,3105,0,28.90499194847,3.7478260869565,0,61,171,171,0
"Fri Aug 1 06:28:59 2008 +0000",51,358,134500,0.10127936623566,46644,87856,0,0,0,565,0,565,158.62300884956,3101,3101,0,3101,0,28.900999677523,3.7487907126733,0,61,171,171,0
"Thu Jul 31 23:50:32 2008 +0000",51,358,134695,0.10148616097805,46683,88012,0,0,0,565,0,565,158.57345132743,3098,3098,0,3098,0,28.919948353777,3.7533892834087,0,77,171,171,0
"Wed Jul 30 21:14:22 2008 +0000",51,354,133777,0.10254945858272,46229,87548,0,0,0,554,0,554,160.83935018051,3084,3084,0,3084,0,28.892671854734,3.780804150454,0,77,171,171,0
"Wed Jul 30 13:39:17 2008 +0000",51,353,133496,0.1021958782941,46105,87391,0,0,0,552,0,552,161.15036231884,3075,3075,0,3075,0,28.928455284553,3.7749593495935,0,77,170,170,0
"Sun Jul 27 04:19:54 2008 +0000",51,353,133136,0.10193512906589,45855,87281,0,0,0,552,0,552,160.8768115942,3072,3072,0,3072,0,28.907552083333,3.7666015625,0,77,170,170,0
"Thu Jul 24 04:04:21 2008 +0000",51,353,132907,0.10201644389325,45823,87084,0,0,0,552,0,552,160.5018115942,3067,3067,0,3067,0,28.887186175416,3.7668731659602,0,77,170,170,0
"Mon Jul 21 02:40:58 2008 +0000",51,351,132727,0.1020351845464,45757,86970,0,0,0,550,0,550,160.88545454545,3064,3064,0,3064,0,28.879569190601,3.766318537859,0,77,170,170,0
"Tue Jul 15 02:13:14 2008 +0000",51,351,132493,0.10221131353637,45712,86781,0,0,0,549,0,549,160.81420765027,3061,3061,0,3061,0,28.842535119242,3.7677229663509,0,77,170,170,0
"Wed Jul 9 03:15:01 2008 +0000",51,351,132084,0.10263532516232,45681,86403,0,0,0,549,0,549,160.11657559199,3055,3055,0,3055,0,28.773813420622,3.772504091653,0,77,170,170,0
"Sat Jul 5 12:37:18 2008 +0000",51,351,131903,0.10277729460196,45668,86235,0,0,0,548,0,548,160.1003649635,3053,3053,0,3053,0,28.737307566328,3.7726826072715,0,77,170,170,0
"Thu Jul 3 17:34:09 2008 +0000",51,351,131774,0.10288448139719,45658,86116,0,0,0,547,0,547,160.17550274223,3051,3051,0,3051,0,28.717141920682,3.7735168797116,0,77,170,170,0
"Sun Jun 29 20:24:06 2008 +0000",51,351,131684,0.10298817977894,45645,86039,0,0,0,547,0,547,160.0310786106,3050,3050,0,3050,0,28.700655737705,3.7747540983607,0,77,170,170,0
"Fri Jun 27 06:46:42 2008 +0000",51,351,131702,0.10294271408158,45625,86077,0,0,0,547,0,547,159.98171846435,3049,3049,0,3049,0,28.701213512627,3.775664152181,0,77,170,170,0
"Thu Jun 26 21:13:10 2008 +0000",51,351,131806,0.1029833586882,45695,86111,0,0,0,547,0,547,160.05484460695,3063,3063,0,3063,0,28.583088475351,3.7652628142344,0,77,170,170,0
"Thu Jun 26 06:05:15 2008 +0000",51,351,131532,0.10308365940004,45660,85872,0,0,0,547,0,547,159.61608775137,3064,3064,0,3064,0,28.495430809399,3.759138381201,0,77,170,170,0
"Tue Jun 24 01:09:54 2008 +0000",51,351,131344,0.10314424332898,45600,85744,0,0,0,546,0,546,159.66483516484,3059,3059,0,3059,0,28.498528931023,3.7610330173259,0,77,170,170,0
"Mon Jun 23 00:07:33 2008 +0000",51,351,131257,0.10317339900328,45576,85681,0,0,0,546,0,546,159.54029304029,3055,3055,0,3055,0,28.513584288052,3.7636661211129,0,77,169,169,0
"Sat Jun 21 23:55:03 2008 +0000",51,346,130640,0.10336591933501,45225,85415,0,0,0,536,0,536,162.00932835821,3052,3052,0,3052,0,28.45249017038,3.7627785058978,0,77,169,169,0
"Fri Jun 20 11:57:56 2008 +0000",51,346,130314,0.1036179382097,45155,85159,0,0,0,536,0,536,161.49813432836,3049,3049,0,3049,0,28.390619875369,3.7638570022958,0,77,169,169,0
"Wed Jun 18 17:28:17 2008 +0000",51,346,130244,0.10358963516339,45110,85134,0,0,0,536,0,536,161.48507462687,3048,3048,0,3048,0,28.397637795276,3.7644356955381,0,77,169,169,0
"Mon Jun 16 03:11:32 2008 +0000",51,346,130178,0.10363266697223,45089,85089,0,0,0,536,0,536,161.39925373134,3044,3044,0,3044,0,28.419842312746,3.7680683311432,0,77,169,169,0
"Sat Jun 14 21:40:01 2008 +0000",51,343,129742,0.10383872183995,44870,84872,0,0,0,530,0,530,162.8,3042,3042,0,3042,0,28.364234056542,3.7682445759369,0,77,169,169,0
"Fri Jun 13 14:04:28 2008 +0000",51,343,129955,0.10397909825937,44986,84969,0,0,0,530,0,530,163.02830188679,3064,3064,0,3064,0,28.200065274151,3.7555483028721,0,77,169,169,0
"Wed Jun 11 02:47:50 2008 +0000",51,343,129917,0.10387867084285,44991,84926,0,0,0,529,0,529,163.28355387524,3064,3064,0,3064,0,28.19092689295,3.7529373368146,0,77,169,169,0
"Mon Jun 9 23:32:54 2008 +0000",51,343,129503,0.10435882881604,44939,84564,0,0,0,525,0,525,163.8780952381,3050,3050,0,3050,0,28.208524590164,3.7685245901639,0,77,169,169,0
"Sat Jun 7 15:19:57 2008 +0000",51,343,129390,0.1044512844797,44920,84470,0,0,0,525,0,525,163.6819047619,3047,3047,0,3047,0,28.202494256646,3.7709222185756,0,77,169,169,0
"Wed Jun 4 21:01:51 2008 +0000",51,343,126488,0.1040629497676,41722,84766,0,0,0,523,0,523,163.92543021033,3042,3042,0,3042,0,28.183103221565,3.7748191978961,0,77,169,169,0
"Tue Jun 3 22:33:21 2008 +0000",51,343,126345,0.10427346389171,41683,84662,0,0,0,520,0,520,164.68461538462,3037,3037,0,3037,0,28.197563384919,3.7823510042805,0,77,168,168,0
"Tue Jun 3 02:41:29 2008 +0000",51,343,126307,0.10431901550112,41797,84510,0,0,0,520,0,520,164.41730769231,3038,3038,0,3038,0,28.142527978934,3.7774851876234,0,77,168,168,0
"Mon Jun 2 04:57:06 2008 +0000",51,343,117170,0.10317488201056,31781,85389,0,0,0,520,0,520,163.36153846154,3036,3036,0,3036,0,27.98023715415,3.7783267457181,0,77,168,168,0
"Sat May 31 21:33:37 2008 +0000",51,340,116900,0.10334146799324,31668,85232,0,0,0,515,0,515,164.6640776699,3032,3032,0,3032,0,27.968997361478,3.7813324538259,0,77,168,168,0
"Sat May 31 02:59:55 2008 +0000",51,340,116696,0.10343895444502,31612,85084,0,0,0,512,0,512,165.328125,3021,3021,0,3021,0,28.019860973188,3.7891426679907,0,77,168,168,0
"Thu May 29 12:27:23 2008 +0000",51,340,116584,0.10345517452397,31610,84974,0,0,0,512,0,512,165.109375,3019,3019,0,3019,0,28.001324942034,3.7876780390858,0,77,168,168,0
"Tue May 27 00:07:00 2008 +0000",51,340,116427,0.10363775720771,31622,84805,0,0,0,512,0,512,164.78515625,3017,3017,0,3017,0,27.964865760689,3.7888631090487,0,77,168,168,0
"Sat May 24 02:08:56 2008 +0000",51,340,116162,0.10376956912453,31590,84572,0,0,0,512,0,512,164.328125,3013,3013,0,3013,0,27.92432791238,3.7882509127116,0,77,168,168,0
"Fri May 23 07:09:16 2008 +0000",51,340,116086,0.10379803766082,31595,84491,0,0,0,512,0,512,164.166015625,3012,3012,0,3012,0,27.90604249668,3.7871845949535,0,77,168,168,0
"Thu May 22 23:04:36 2008 +0000",51,339,115865,0.1038024527362,31551,84314,0,0,0,507,0,507,165.45562130178,3003,3003,0,3003,0,27.934065934066,3.7895437895438,0,77,168,168,0
"Thu May 22 14:18:21 2008 +0000",51,339,115716,0.10380585845628,31530,84186,0,0,0,507,0,507,165.20118343195,3001,3001,0,3001,0,27.909696767744,3.786737754082,0,77,168,168,0
"Wed May 21 23:45:58 2008 +0000",51,339,115592,0.10384697737492,31526,84066,0,0,0,506,0,506,165.29446640316,2997,2997,0,2997,0,27.907574240908,3.7874541207875,0,77,168,168,0
"Tue May 20 14:14:16 2008 +0000",51,339,115435,0.10383125782041,31520,83915,0,0,0,506,0,506,164.99407114625,2997,2997,0,2997,0,27.856856856857,3.7817817817818,0,77,168,168,0
"Tue May 20 00:50:06 2008 +0000",51,339,115385,0.10378246927414,31498,83887,0,0,0,506,0,506,164.94664031621,2994,2994,0,2994,0,27.876753507014,3.7832331329325,0,77,168,168,0
"Mon May 19 12:17:37 2008 +0000",51,338,115052,0.10375260099017,31430,83622,0,0,0,505,0,505,164.74653465347,2982,2982,0,2982,0,27.899731723675,3.7843729040912,0,77,168,168,0
"Mon May 19 07:09:53 2008 +0000",51,338,114952,0.10385692738634,31414,83538,0,0,0,505,0,505,164.5801980198,2977,2977,0,2977,0,27.918374202217,3.789049378569,0,77,168,168,0
"Mon May 19 05:08:37 2008 +0000",51,338,114916,0.1038905054424,31405,83511,0,0,0,505,0,505,164.52475247525,2976,2976,0,2976,0,27.918346774194,3.7899865591398,0,77,168,168,0
"Sun May 18 23:34:13 2008 +0000",51,336,114569,0.1042328042328,31409,83160,0,0,0,501,0,501,165.15968063872,2965,2965,0,2965,0,27.907251264755,3.7976391231029,0,77,168,168,0
"Sun May 18 12:49:57 2008 +0000",51,336,113987,0.10474346563408,31347,82640,0,0,0,497,0,497,165.42253521127,2933,2933,0,2933,0,28.031026252983,3.8240709171497,0,77,168,168,0
"Sat May 17 21:45:25 2008 +0000",51,332,109303,0.10778129628684,30987,78316,0,0,0,489,0,489,159.27811860941,2870,2870,0,2870,0,27.138327526132,3.8114982578397,0,77,168,168,0
"Sat May 17 00:48:34 2008 +0000",51,332,109084,0.10791127494272,30955,78129,0,0,0,489,0,489,158.88752556237,2861,2861,0,2861,0,27.15693813352,3.8168472562041,0,77,168,168,0
"Thu May 15 23:57:24 2008 +0000",51,331,107125,0.1099801943836,30884,76241,0,0,0,486,0,486,155.98971193416,2815,2815,0,2815,0,26.93108348135,3.8465364120782,0,77,168,168,0
"Thu May 15 06:42:31 2008 +0000",51,331,107034,0.11022980958634,30884,76150,0,0,0,486,0,486,155.7962962963,2811,2811,0,2811,0,26.935965848453,3.8537886872999,0,77,168,168,0
"Thu May 15 02:05:05 2008 +0000",51,329,106738,0.11038088715625,30810,75928,0,0,0,482,0,482,156.64730290456,2803,2803,0,2803,0,26.936853371388,3.8572957545487,0,77,168,168,0
"Wed May 14 02:24:58 2008 +0000",51,329,106658,0.11052659336023,30812,75846,0,0,0,483,0,483,156.15734989648,2803,2803,0,2803,0,26.908312522298,3.8583660363896,0,77,168,168,0
"Tue May 13 21:27:33 2008 +0000",51,334,106692,0.11307603457203,31371,75321,0,0,0,482,0,482,155.67427385892,2804,2804,0,2804,0,26.759985734665,3.9054921540656,0,77,167,167,0
"Tue May 13 14:22:57 2008 +0000",51,333,106743,0.11316044563067,31434,75309,0,0,0,482,0,482,155.70746887967,2819,2819,0,2819,0,26.623270663356,3.8918056048244,0,77,167,167,0
"Tue May 13 05:23:57 2008 +0000",51,333,106061,0.1140230993917,31427,74634,0,0,0,479,0,479,155.29853862213,2789,2789,0,2789,0,26.671925421298,3.9196844747221,0,77,166,166,0
"Tue May 13 01:03:11 2008 +0000",51,330,95832,0.1253721722582,30674,65158,0,0,0,473,0,473,137.03171247357,2728,2728,0,2728,0,23.759530791789,3.8651026392962,0,64,165,165,0
"Mon May 12 06:04:56 2008 +0000",51,330,95557,0.12580331961718,30670,64887,0,0,0,472,0,472,136.75,2712,2712,0,2712,0,23.800147492625,3.8797935103245,0,64,165,165,0
"Sun May 11 18:27:39 2008 +0000",50,328,94741,0.12705786979297,30597,64144,0,0,0,467,0,467,136.77516059957,2691,2691,0,2691,0,23.736157562245,3.8974358974359,0,64,165,165,0
"Sat May 10 17:29:28 2008 +0000",50,328,96399,0.12741607713111,30952,65447,0,0,0,467,0,467,139.95074946467,2695,2695,0,2695,0,24.25120593692,3.9643784786642,0,64,165,165,0
"Sat May 10 03:20:06 2008 +0000",50,328,96078,0.12793340705246,30966,65112,0,0,0,467,0,467,139.25053533191,2697,2697,0,2697,0,24.11197626993,3.9592139414164,0,64,165,165,0
"Thu May 8 15:33:54 2008 +0000",50,328,95674,0.12871623709747,30958,64716,0,0,0,467,0,467,138.3982869379,2685,2685,0,2685,0,24.071508379888,3.9724394785847,0,64,165,165,0
"Mon May 5 17:54:05 2008 +0000",50,328,95430,0.12893072008931,30938,64492,0,0,0,467,0,467,137.92077087794,2676,2676,0,2676,0,24.06913303438,3.9768310911809,0,64,165,165,0
"Mon May 5 14:19:19 2008 +0000",50,328,94817,0.129205753596,30857,63960,0,0,0,467,0,467,136.78800856531,2646,2646,0,2646,0,24.142101284958,3.9928193499622,0,64,165,165,0
"Thu May 1 19:35:12 2008 +0000",50,328,93929,0.13089802130898,30857,63072,0,0,0,467,0,467,134.88650963597,2644,2644,0,2644,0,23.824508320726,3.9920574886536,0,64,165,165,0
"Tue Apr 29 18:24:52 2008 +0000",50,328,93766,0.13091001525165,30822,62944,0,0,0,467,0,467,134.61670235546,2642,2642,0,2642,0,23.794852384557,3.9894019682059,0,64,164,164,0
"Sat Apr 26 14:12:33 2008 +0000",49,326,91956,0.13297343140933,30643,61313,0,0,0,464,0,464,131.95905172414,2618,2618,0,2618,0,23.387700534759,3.9839572192513,0,64,162,162,0
"Wed Apr 23 15:24:57 2008 +0000",49,324,91324,0.13332676065595,30466,60858,0,0,0,461,0,461,131.88286334056,2586,2586,0,2586,0,23.510440835267,4.0085073472544,0,63,162,162,0
"Sat Apr 19 20:57:23 2008 +0000",49,324,91118,0.13319922171289,30472,60646,0,0,0,461,0,461,131.4251626898,2586,2586,0,2586,0,23.428847641145,3.9945862335654,0,63,162,162,0
"Fri Apr 18 06:58:14 2008 +0000",49,324,90860,0.1336025019443,30427,60433,0,0,0,461,0,461,130.94793926247,2564,2564,0,2564,0,23.544071762871,4.01872074883,0,63,162,162,0
"Thu Apr 17 22:30:25 2008 +0000",49,324,90643,0.13367971979217,30402,60241,0,0,0,461,0,461,130.51626898048,2555,2555,0,2555,0,23.549119373777,4.0211350293542,0,63,162,162,0
"Wed Apr 16 20:24:59 2008 +0000",49,324,90580,0.13384858306324,30415,60165,0,0,0,459,0,459,130.94989106754,2552,2552,0,2552,0,23.552507836991,4.0246865203762,0,63,162,162,0
"Tue Apr 15 16:46:46 2008 +0000",49,324,90528,0.13376802674695,30409,60119,0,0,0,459,0,459,130.84967320261,2552,2552,0,2552,0,23.534482758621,4.0203761755486,0,63,162,162,0
"Fri Apr 11 05:48:39 2008 +0000",49,324,90413,0.13385551204066,30408,60005,0,0,0,459,0,459,130.60130718954,2551,2551,0,2551,0,23.49901999216,4.0176401411211,0,63,162,162,0
"Wed Apr 9 15:34:03 2008 +0000",49,324,90453,0.13362865755158,30406,60047,0,0,0,459,0,459,130.69063180828,2549,2549,0,2549,0,23.533542565712,4.0168693605335,0,63,162,162,0
"Fri Apr 4 23:55:02 2008 +0000",49,324,90355,0.13384158547978,30411,59944,0,0,0,459,0,459,130.46405228758,2547,2547,0,2547,0,23.511189634865,4.0188457008245,0,63,162,162,0
"Wed Apr 2 19:35:14 2008 +0000",49,324,90139,0.1341714515292,30402,59737,0,0,0,459,0,459,130.00871459695,2541,2541,0,2541,0,23.484454939,4.0228256591893,0,63,162,162,0
"Mon Mar 31 17:49:39 2008 +0000",49,323,90066,0.13422785064576,30369,59697,0,0,0,458,0,458,130.21179039301,2539,2539,0,2539,0,23.488381252462,4.0244190626231,0,63,162,162,0
"Wed Mar 26 04:51:02 2008 +0000",49,322,89868,0.13447876253338,30327,59541,0,0,0,456,0,456,130.43859649123,2536,2536,0,2536,0,23.454258675079,4.0256309148265,0,63,162,162,0
"Thu Mar 20 07:17:37 2008 +0000",47,319,89707,0.13467651065404,30246,59461,0,0,0,456,0,456,130.27631578947,2534,2534,0,2534,0,23.443567482242,4.0284135753749,0,63,162,162,0
"Sun Mar 16 05:44:20 2008 +0000",47,318,89477,0.13489023505391,30214,59263,0,0,0,452,0,452,131.0110619469,2531,2531,0,2531,0,23.396681153694,4.0264717502963,0,63,162,162,0
"Sat Mar 15 05:30:30 2008 +0000",47,317,89208,0.13481757385931,30143,59065,0,0,0,451,0,451,130.85144124169,2526,2526,0,2526,0,23.362628661916,4.020190023753,0,63,162,162,0
"Wed Mar 12 21:19:31 2008 +0000",47,315,88739,0.13501498841804,30027,58712,0,0,0,447,0,447,131.23713646532,2519,2519,0,2519,0,23.288209606987,4.0142913854704,0,63,162,162,0
"Mon Mar 10 11:01:37 2008 +0000",45,313,88554,0.13549839667053,29926,58628,0,0,0,443,0,443,132.230248307,2510,2510,0,2510,0,23.337848605578,4.0322709163347,0,63,162,162,0
"Sun Mar 9 22:15:08 2008 +0000",45,313,88426,0.13557496709345,29927,58499,0,0,0,443,0,443,131.94130925508,2506,2506,0,2506,0,23.324022346369,4.0319233838787,0,63,162,162,0
"Sun Mar 9 07:00:05 2008 +0000",45,313,88249,0.13565452924638,29917,58332,0,0,0,443,0,443,131.58013544018,2504,2504,0,2504,0,23.27875399361,4.0279552715655,0,63,162,162,0
"Sat Mar 8 20:33:22 2008 +0000",45,313,88204,0.1355513634025,29894,58310,0,0,0,443,0,443,131.27088036117,2501,2501,0,2501,0,23.251899240304,4.0203918432627,0,70,161,161,0
"Sat Mar 8 04:30:55 2008 +0000",45,313,88152,0.13558594889571,29879,58273,0,0,0,443,0,443,131.17155756208,2496,2496,0,2496,0,23.280849358974,4.0248397435897,0,70,161,161,0
"Mon Mar 3 16:01:46 2008 +0000",45,313,87884,0.13629627076584,29856,58028,0,0,0,443,0,443,130.58239277652,2492,2492,0,2492,0,23.213483146067,4.0308988764045,0,70,161,161,0
"Sat Mar 1 03:25:46 2008 +0000",45,313,87766,0.13620350222775,29860,57906,0,0,0,443,0,443,130.31151241535,2490,2490,0,2490,0,23.183935742972,4.0244979919679,0,70,161,161,0
"Thu Feb 28 01:57:59 2008 +0000",45,313,87569,0.13445218053968,29831,57738,0,0,0,442,0,442,130.19683257919,2492,2492,0,2492,0,23.092696629213,3.9723113964687,0,70,161,161,0
"Sun Feb 24 03:20:43 2008 +0000",45,312,87462,0.13454671520194,29772,57690,0,0,0,439,0,439,130.99772209567,2486,2486,0,2486,0,23.132743362832,3.9798873692679,0,70,159,159,0
"Fri Feb 15 20:47:44 2008 +0000",45,309,86931,0.13468518777049,29627,57304,0,0,0,434,0,434,131.6267281106,2462,2462,0,2462,0,23.203086921202,3.9910641754671,0,70,159,159,0
"Mon Feb 11 06:18:41 2008 +0000",45,309,86864,0.13475883514141,29621,57243,0,0,0,432,0,432,132.11111111111,2457,2457,0,2457,0,23.228327228327,3.996336996337,0,70,158,158,0
"Wed Feb 6 17:34:55 2008 +0000",45,309,86671,0.13524784048499,29598,57073,0,0,0,431,0,431,132.03016241299,2443,2443,0,2443,0,23.29308227589,4.0155546459271,0,70,158,158,0
"Mon Feb 4 16:59:52 2008 +0000",45,309,86492,0.1352068614011,29594,56898,0,0,0,431,0,431,131.62645011601,2438,2438,0,2438,0,23.269483182937,4.0110746513536,0,70,158,158,0
"Fri Feb 1 05:00:44 2008 +0000",45,309,86259,0.13580551831205,29575,56684,0,0,0,429,0,429,131.73892773893,2433,2433,0,2433,0,23.228935470612,4.0193177147554,0,70,158,158,0
"Mon Jan 28 01:14:05 2008 +0000",45,309,85158,0.13479702035143,29044,56114,0,0,0,426,0,426,130.94366197183,2388,2388,0,2388,0,23.359296482412,4.0201005025126,0,70,158,158,0
"Tue Jan 22 23:17:55 2008 +0000",45,309,84930,0.13477942096887,29009,55921,0,0,0,426,0,426,130.4765258216,2381,2381,0,2381,0,23.344393112138,4.0176396472071,0,70,158,158,0
"Sun Jan 20 02:54:32 2008 +0000",45,309,84863,0.13458164763166,29001,55862,0,0,0,426,0,426,130.33568075117,2380,2380,0,2380,0,23.328991596639,4.0109243697479,0,70,158,158,0
"Wed Jan 16 07:34:42 2008 +0000",45,309,84731,0.13444292990889,28975,55756,0,0,0,426,0,426,130.07746478873,2377,2377,0,2377,0,23.312158182583,4.0054690786706,0,70,158,158,0
"Sun Jan 13 03:53:01 2008 +0000",45,309,84570,0.13463163762565,28959,55611,0,0,0,426,0,426,129.73004694836,2374,2374,0,2374,0,23.279275484414,4.0054759898905,0,70,158,158,0
"Fri Jan 11 06:45:30 2008 +0000",44,307,84386,0.13494809688581,28898,55488,0,0,0,423,0,423,130.36879432624,2371,2371,0,2371,0,23.258540700127,4.0097005482919,0,70,158,158,0
"Wed Jan 9 14:44:02 2008 +0000",44,307,84375,0.13532304256201,28856,55519,0,0,0,422,0,422,130.77251184834,2362,2362,0,2362,0,23.364098221846,4.0317527519052,0,70,158,158,0
"Tue Jan 8 15:46:02 2008 +0000",44,307,84062,0.13508867173362,28802,55260,0,0,0,422,0,422,130.14218009479,2356,2356,0,2356,0,23.310696095076,4.0191001697793,0,70,158,158,0
"Sun Jan 6 11:34:56 2008 +0000",44,306,83984,0.13497654707789,28767,55217,0,0,0,421,0,421,130.3539192399,2356,2356,0,2356,0,23.293293718166,4.0140067911715,0,70,158,158,0
"Thu Jan 3 19:41:06 2008 +0000",44,306,83845,0.13495016973152,28758,55087,0,0,0,421,0,421,130.04038004751,2353,2353,0,2353,0,23.266893327667,4.0097747556311,0,70,158,158,0
"Wed Jan 2 05:32:31 2008 +0000",44,301,83513,0.13529850882144,28590,54923,0,0,0,413,0,413,132.22033898305,2351,2351,0,2351,0,23.227137388345,4.0114844746916,0,70,154,154,0
"Tue Jan 1 22:52:25 2008 +0000",44,301,83319,0.13549353401037,28571,54748,0,0,0,413,0,413,131.8014527845,2344,2344,0,2344,0,23.222696245734,4.0149317406143,0,70,154,154,0
"Mon Dec 31 18:12:44 2007 +0000",44,301,82898,0.13565649135712,28518,54380,0,0,0,412,0,412,131.21359223301,2331,2331,0,2331,0,23.191763191763,4.014157014157,0,70,154,154,0
"Sat Dec 29 21:10:41 2007 +0000",44,301,82484,0.13562618068674,28490,53994,0,0,0,411,0,411,130.57420924574,2323,2323,0,2323,0,23.102023245803,4.0004304778304,0,70,157,157,0
"Thu Dec 27 08:33:29 2007 +0000",44,301,82342,0.13573484356141,28487,53855,0,0,0,410,0,410,130.56097560976,2317,2317,0,2317,0,23.103150625809,4.0025895554596,0,70,157,157,0
"Tue Dec 25 10:07:27 2007 +0000",44,301,82183,0.13550488599349,28458,53725,0,0,0,410,0,410,130.23170731707,2314,2314,0,2314,0,23.074762316335,3.9935177182368,0,70,157,157,0
"Tue Dec 25 05:30:54 2007 +0000",44,298,81903,0.13576740535894,28385,53518,0,0,0,407,0,407,130.71007371007,2311,2311,0,2311,0,23.019904803116,3.9913457377759,0,70,157,157,0
"Sun Dec 23 21:08:54 2007 +0000",42,296,81392,0.13612929931512,28244,53148,0,0,0,405,0,405,130.42716049383,2303,2303,0,2303,0,22.936604429006,3.9887103777681,0,70,157,157,0
"Sun Dec 23 10:27:48 2007 +0000",42,296,81229,0.13623587557299,28218,53011,0,0,0,402,0,402,131.08706467662,2300,2300,0,2300,0,22.911739130435,3.9895652173913,0,70,157,157,0
"Sun Dec 23 06:45:26 2007 +0000",42,296,81187,0.13632502029489,28218,52969,0,0,0,402,0,402,130.97512437811,2299,2299,0,2299,0,22.902131361462,3.9899956502827,0,70,156,156,0
"Sat Dec 22 19:49:02 2007 +0000",42,296,80878,0.13674856643755,28212,52666,0,0,0,402,0,402,130.2263681592,2292,2292,0,2292,0,22.8407504363,3.9908376963351,0,70,156,156,0
"Sat Dec 22 04:20:35 2007 +0000",42,296,80504,0.13667896114816,28177,52327,0,0,0,402,0,402,129.37313432836,2286,2286,0,2286,0,22.750656167979,3.9768153980752,0,70,156,156,0
"Fri Dec 21 18:14:10 2007 +0000",42,296,80290,0.13688431797686,28173,52117,0,0,0,402,0,402,128.84577114428,2281,2281,0,2281,0,22.70758439281,3.9754493643139,0,70,156,156,0
"Tue Dec 18 18:19:30 2007 +0000",42,295,79859,0.13721365575004,28042,51817,0,0,0,400,0,400,128.6925,2267,2267,0,2267,0,22.70710189678,3.9836788707543,0,70,156,156,0
"Sat Dec 15 16:30:07 2007 +0000",41,291,79565,0.13743029739777,27917,51648,0,0,0,396,0,396,129.58585858586,2262,2262,0,2262,0,22.686118479222,3.9849690539346,0,70,156,156,0
"Fri Dec 14 05:40:00 2007 +0000",41,289,79364,0.13861328466303,27861,51503,0,0,0,388,0,388,131.93041237113,2239,2239,0,2239,0,22.862438588656,4.0343903528361,0,70,156,156,0
"Mon Dec 10 03:28:21 2007 +0000",41,290,79689,0.13816337199171,28040,51649,0,0,0,434,0,434,118.14746543779,2246,2246,0,2246,0,22.829919857524,4.0227070347284,0,70,157,157,0
"Sat Dec 8 07:10:19 2007 +0000",41,290,79598,0.13826403971455,28030,51568,0,0,0,434,0,434,117.96082949309,2243,2243,0,2243,0,22.824342398573,4.0240748996879,0,70,157,157,0
"Thu Dec 6 07:43:19 2007 +0000",41,290,79410,0.13854507239608,28026,51384,0,0,0,434,0,434,117.53456221198,2239,2239,0,2239,0,22.782492184011,4.0245645377401,0,70,157,157,0
"Sun Dec 2 23:50:40 2007 +0000",41,290,79348,0.1385565644363,28026,51322,0,0,0,434,0,434,117.38940092166,2237,2237,0,2237,0,22.774698256594,4.0236924452392,0,70,157,157,0
"Fri Nov 30 22:27:43 2007 +0000",41,290,79309,0.13858393619718,28026,51283,0,0,0,434,0,434,117.30184331797,2235,2235,0,2235,0,22.77807606264,4.0246085011186,0,70,157,157,0
"Tue Nov 27 00:33:10 2007 +0000",41,290,79232,0.1385354047935,27996,51236,0,0,0,434,0,434,117.18894009217,2233,2233,0,2233,0,22.776533811017,4.0232870577698,0,70,157,157,0
"Sun Nov 25 18:49:41 2007 +0000",41,290,79135,0.13884055137355,27990,51145,0,0,0,434,0,434,116.97004608295,2233,2233,0,2233,0,22.733990147783,4.0241827138379,0,70,157,157,0
"Sat Nov 24 06:13:16 2007 +0000",41,286,78796,0.13876639030987,27775,51021,0,0,0,430,0,430,117.77674418605,2222,2222,0,2222,0,22.792079207921,4.029702970297,0,70,157,157,0
"Fri Nov 23 00:24:28 2007 +0000",39,284,78708,0.13921441611213,27765,50943,0,0,0,428,0,428,118.09345794393,2218,2218,0,2218,0,22.788097385032,4.0356176735798,0,70,155,155,0
"Thu Nov 22 17:28:09 2007 +0000",39,284,78698,0.13923628153529,27763,50935,0,0,0,428,0,428,118.07476635514,2218,2218,0,2218,0,22.784490532011,4.0356176735798,0,70,155,155,0
"Wed Nov 21 17:37:55 2007 +0000",39,284,78750,0.1395672727986,27771,50979,0,0,0,428,0,428,118.18691588785,2218,2218,0,2218,0,22.806131650135,4.046438232642,0,70,155,155,0
"Mon Nov 19 14:08:37 2007 +0000",39,284,78747,0.14001333647133,27759,50988,0,0,0,428,0,428,118.20093457944,2216,2216,0,2216,0,22.829422382671,4.0600180505415,0,70,155,155,0
"Sat Nov 17 22:46:55 2007 +0000",39,284,78210,0.14056375945208,27692,50518,0,0,0,428,0,428,117.06542056075,2206,2206,0,2206,0,22.71260199456,4.0566636446056,0,70,155,155,0
"Fri Nov 16 18:20:52 2007 +0000",39,283,77581,0.14133951036383,27503,50078,0,0,0,381,0,381,130.51181102362,2191,2191,0,2191,0,22.695116385212,4.0680054769512,0,70,154,154,0
"Thu Nov 15 09:52:29 2007 +0000",39,282,77109,0.14185195609344,27367,49742,0,0,0,375,0,375,130.784,2171,2171,0,2171,0,22.590511285122,4.0502072777522,0,70,154,154,0
"Mon Nov 12 03:26:34 2007 +0000",39,281,76865,0.14208985360929,27340,49525,0,0,0,374,0,374,130.56684491979,2170,2170,0,2170,0,22.503225806452,4.0428571428571,0,70,154,154,0
"Fri Nov 9 08:00:59 2007 +0000",39,281,76723,0.14137449675292,27294,49429,0,0,0,374,0,374,130.30748663102,2163,2163,0,2163,0,22.53120665742,4.0300508552936,0,70,154,154,0
"Thu Nov 8 00:05:12 2007 +0000",39,281,76828,0.14194902427704,27275,49553,0,0,0,371,0,371,131.61725067385,2158,2158,0,2158,0,22.627432808156,4.0528266913809,0,70,154,154,0
"Tue Nov 6 04:02:12 2007 +0000",39,281,76573,0.14201927955353,27298,49275,0,0,0,371,0,371,130.91105121294,2155,2155,0,2155,0,22.537354988399,4.0403712296984,0,70,154,154,0
"Sun Nov 4 18:07:59 2007 +0000",39,281,76429,0.14214919674229,27192,49237,0,0,0,370,0,370,131.16756756757,2152,2152,0,2152,0,22.552044609665,4.0450743494424,0,70,154,154,0
"Fri Nov 2 06:21:41 2007 +0000",39,278,76010,0.14247476604961,27068,48942,0,0,0,365,0,365,132.18630136986,2128,2128,0,2128,0,22.672932330827,4.0671992481203,0,70,154,154,0
"Tue Oct 30 16:17:58 2007 +0000",39,278,75899,0.14253592526727,26978,48921,0,0,0,365,0,365,132.09863013699,2127,2127,0,2127,0,22.668547249647,4.0686412787964,0,70,154,154,0
"Sun Oct 28 21:42:24 2007 +0000",39,278,75770,0.14251455275888,26982,48788,0,0,0,365,0,365,131.7397260274,2121,2121,0,2121,0,22.670909948138,4.0678925035361,0,70,154,154,0
"Sat Oct 27 03:27:09 2007 +0000",39,278,75633,0.14201146944564,26982,48651,0,0,0,365,0,365,131.23287671233,2122,2122,0,2122,0,22.573044297832,4.0419415645617,0,71,154,154,0
"Wed Oct 24 18:53:25 2007 +0000",39,278,75720,0.14278676410214,27004,48716,0,0,0,365,0,365,131.2904109589,2123,2123,0,2123,0,22.572303344324,4.0565237870937,0,72,154,154,0
"Wed Oct 24 11:31:32 2007 +0000",39,276,75552,0.14304521331304,26938,48614,0,0,0,361,0,361,132.48476454294,2120,2120,0,2120,0,22.559905660377,4.0599056603774,0,72,154,154,0
"Mon Oct 22 23:52:12 2007 +0000",39,276,75317,0.14321701424737,26887,48430,0,0,0,360,0,360,132.38888888889,2114,2114,0,2114,0,22.544938505203,4.0633869441816,0,72,154,154,0
"Mon Oct 22 19:56:21 2007 +0000",39,269,74834,0.14377864891212,26621,48213,0,0,0,345,0,345,137.58260869565,2109,2109,0,2109,0,22.50640113798,4.0687529634898,0,72,154,154,0
"Mon Oct 22 06:58:51 2007 +0000",39,269,74830,0.14381132153747,26621,48209,0,0,0,345,0,345,137.5768115942,2109,2109,0,2109,0,22.505452821242,4.0697012802276,0,72,154,154,0
"Mon Oct 22 00:07:39 2007 +0000",39,269,74862,0.14313122769377,26389,48473,0,0,0,345,0,345,138.23768115942,2109,2109,0,2109,0,22.61356092935,4.0720720720721,0,72,154,154,0
"Sun Oct 21 17:37:25 2007 +0000",39,269,74768,0.14304592005286,26336,48432,0,0,0,345,0,345,138.11014492754,2108,2108,0,2108,0,22.603415559772,4.0687855787476,0,72,154,154,0
"Sat Oct 20 21:09:24 2007 +0000",39,269,74722,0.14313470163907,26341,48381,0,0,0,344,0,344,138.37209302326,2106,2106,0,2106,0,22.602089268756,4.0702754036087,0,72,154,154,0
"Sat Oct 20 05:55:37 2007 +0000",39,269,74638,0.14297837110628,26323,48315,0,0,0,344,0,344,138.15697674419,2105,2105,0,2105,0,22.577672209026,4.0636579572447,0,72,154,154,0
"Fri Oct 19 08:46:22 2007 +0000",39,269,74536,0.14282453519256,26344,48192,0,0,0,344,0,344,137.8023255814,2104,2104,0,2104,0,22.530418250951,4.0532319391635,0,72,154,154,0
"Thu Oct 18 19:55:20 2007 +0000",39,269,74464,0.14267613825191,26320,48144,0,0,0,344,0,344,137.65406976744,2103,2103,0,2103,0,22.516880646695,4.0480266286258,0,72,154,154,0
"Wed Oct 17 12:56:14 2007 +0000",39,269,74350,0.14293744144894,26315,48035,0,0,0,344,0,344,137.34302325581,2100,2100,0,2100,0,22.498095238095,4.0509523809524,0,72,154,154,0
"Tue Oct 16 04:41:00 2007 +0000",39,269,73879,0.14341892204488,26326,47553,0,0,0,337,0,337,138.89317507418,2086,2086,0,2086,0,22.438638542665,4.0527325023969,0,72,168,168,0
"Sun Oct 14 19:18:24 2007 +0000",39,269,73783,0.14375421443021,26327,47456,0,0,0,337,0,337,138.58160237389,2084,2084,0,2084,0,22.409788867562,4.0566218809981,0,72,168,168,0
"Wed Oct 10 00:19:16 2007 +0000",39,269,73713,0.1441003759875,26371,47342,0,0,0,347,0,347,134.12391930836,2074,2074,0,2074,0,22.440212150434,4.0636451301832,0,72,174,174,0
"Tue Oct 9 00:00:46 2007 +0000",39,269,73548,0.14410082609617,26338,47210,0,0,0,347,0,347,133.71469740634,2067,2067,0,2067,0,22.447508466376,4.0648282535075,0,72,174,174,0
"Sat Oct 6 04:49:54 2007 +0000",39,269,73356,0.14438093619191,26293,47063,0,0,0,347,0,347,133.26801152738,2057,2057,0,2057,0,22.48128342246,4.0758385999028,0,72,174,174,0
"Thu Oct 4 05:09:26 2007 +0000",39,270,73380,0.14484300159659,26405,46975,0,0,0,344,0,344,134.24418604651,2061,2061,0,2061,0,22.406598738476,4.0752062105774,0,72,172,172,0
"Mon Oct 1 15:39:31 2007 +0000",39,269,73041,0.14525175543757,26329,46712,0,0,0,340,0,340,135.07352941176,2052,2052,0,2052,0,22.380604288499,4.0799220272904,0,72,171,171,0
"Thu Sep 27 00:38:03 2007 +0000",38,266,72529,0.14602914546866,26141,46388,0,0,0,337,0,337,135.23442136499,2023,2023,0,2023,0,22.527928818586,4.1166584280771,0,72,179,179,0
"Fri Sep 21 17:04:23 2007 +0000",37,245,68624,0.14681249164699,23730,44894,0,0,0,337,0,337,130.35608308605,2008,2008,0,2008,0,21.877490039841,4.0488047808765,0,72,179,179,0
"Thu Sep 20 14:50:42 2007 +0000",37,243,68140,0.1467863151991,23565,44575,0,0,0,334,0,334,130.5748502994,1996,1996,0,1996,0,21.849699398798,4.0430861723447,0,72,179,179,0
"Mon Sep 17 03:53:06 2007 +0000",37,239,67399,0.14764110248377,23353,44046,0,0,0,329,0,329,130.9726443769,1974,1974,0,1974,0,21.828774062817,4.0572441742655,0,72,178,178,0
"Sun Sep 16 18:43:41 2007 +0000",37,239,67382,0.14758119464002,23352,44030,0,0,0,329,0,329,130.93009118541,1973,1973,0,1973,0,21.832742017233,4.0562595032945,0,72,178,178,0
"Sun Sep 16 01:06:17 2007 +0000",37,239,67139,0.1478979321678,23325,43814,0,0,0,329,0,329,130.35866261398,1966,1966,0,1966,0,21.81485249237,4.0615462868769,0,72,178,178,0
"Fri Sep 14 02:21:52 2007 +0000",37,239,67099,0.14761556398884,23357,43742,0,0,0,329,0,329,130.17021276596,1966,1966,0,1966,0,21.783316378433,4.0498474059003,0,72,178,178,0
"Mon Sep 10 11:58:19 2007 +0000",37,234,66692,0.14840103915213,23195,43497,0,0,0,320,0,320,133.1125,1962,1962,0,1962,0,21.710499490316,4.0550458715596,0,72,178,178,0
"Thu Aug 30 00:58:19 2007 +0000",37,234,66574,0.14874395021894,23184,43390,0,0,0,320,0,320,132.775,1957,1957,0,1957,0,21.710781808891,4.0623403168114,0,72,178,178,0
"Wed Aug 29 03:06:40 2007 +0000",37,234,66434,0.14895289168323,23172,43262,0,0,0,314,0,314,134.92356687898,1951,1951,0,1951,0,21.715017939518,4.0666324961558,0,72,178,178,0
"Tue Aug 28 01:29:00 2007 +0000",37,234,66323,0.14925511457102,23162,43161,0,0,0,312,0,312,135.46153846154,1947,1947,0,1947,0,21.707241910632,4.0724191063174,0,72,178,178,0
"Sat Aug 25 15:29:44 2007 +0000",37,234,66349,0.14932493457771,23168,43181,0,0,0,312,0,312,135.52884615385,1948,1948,0,1948,0,21.706878850103,4.0744353182752,0,72,178,178,0
"Wed Aug 22 17:33:46 2007 +0000",37,233,66163,0.14942368469976,23131,43032,0,0,0,310,0,310,135.95161290323,1947,1947,0,1947,0,21.646122239343,4.0667693888033,0,72,179,179,0
"Tue Aug 21 14:17:45 2007 +0000",37,230,65006,0.1509755635537,22774,42232,0,0,0,294,0,294,140.66666666667,1904,1904,0,1904,0,21.720588235294,4.1113445378151,0,72,179,179,0
"Sun Aug 19 16:53:25 2007 +0000",37,230,64852,0.15112104424737,22793,42059,0,0,0,293,0,293,140.64505119454,1904,1904,0,1904,0,21.643382352941,4.1071428571429,0,72,179,179,0
"Fri Aug 17 09:15:19 2007 +0000",37,226,64420,0.15178166001482,22577,41843,0,0,0,279,0,279,147.02508960573,1903,1903,0,1903,0,21.555438780872,4.1077246452969,0,72,179,179,0
"Wed Aug 15 19:33:46 2007 +0000",37,226,64222,0.15194125833853,22548,41674,0,0,0,279,0,279,146.41218637993,1896,1896,0,1896,0,21.544831223629,4.1091772151899,0,72,184,184,0
"Tue Aug 14 18:49:35 2007 +0000",37,225,64047,0.15244240075114,22510,41537,0,0,0,278,0,278,146.45323741007,1895,1895,0,1895,0,21.484960422164,4.1108179419525,0,72,184,184,0
"Sat Aug 11 16:58:21 2007 +0000",37,223,63783,0.15264074289031,22431,41352,0,0,0,276,0,276,146.85869565217,1889,1889,0,1889,0,21.457384859714,4.1101111699312,0,72,185,185,0
"Tue Aug 7 21:41:38 2007 +0000",37,223,63546,0.1529237205682,22434,41112,0,0,0,276,0,276,146,1884,1884,0,1884,0,21.388535031847,4.1050955414013,0,72,185,185,0
"Sun Aug 5 02:03:18 2007 +0000",37,223,63366,0.1532470703125,22406,40960,0,0,0,275,0,275,145.96363636364,1874,1874,0,1874,0,21.419423692636,4.115795090715,0,72,185,185,0
"Thu Aug 2 19:12:19 2007 +0000",37,223,63338,0.15317735554144,22392,40946,0,0,0,275,0,275,145.52727272727,1870,1870,0,1870,0,21.401069518717,4.1026737967914,0,72,185,185,0
"Fri Jul 27 03:47:11 2007 +0000",37,223,63254,0.15359013264157,22392,40862,0,0,0,275,0,275,145.21090909091,1869,1869,0,1869,0,21.365971107544,4.1064740502943,0,72,186,186,0
"Tue Jul 24 20:02:14 2007 +0000",37,222,62540,0.15553845007822,22267,40273,0,0,0,268,0,268,146.84701492537,1833,1833,0,1833,0,21.470267321331,4.1614839061648,0,71,185,185,0
"Sun Jul 22 03:23:32 2007 +0000",37,222,62353,0.15549798216332,22211,40142,0,0,0,268,0,268,146.35447761194,1828,1828,0,1828,0,21.456783369803,4.1580962800875,0,71,185,185,0
"Mon Jul 9 19:37:23 2007 +0000",35,208,61696,0.15548437148077,21737,39959,0,0,0,254,0,254,153.86220472441,1811,1811,0,1811,0,21.579790171176,4.1717283268912,0,71,185,185,0
"Mon Jul 9 05:27:04 2007 +0000",35,187,60705,0.15638472204714,21040,39665,0,0,0,232,0,232,167.63793103448,1776,1776,0,1776,0,21.898648648649,4.231981981982,0,71,179,179,0
"Sun Jul 8 23:48:05 2007 +0000",35,187,60674,0.15639033250921,21036,39638,0,0,0,232,0,232,167.52155172414,1773,1773,0,1773,0,21.920473773266,4.2351945854484,0,71,179,179,0
"Sun Jul 8 03:38:07 2007 +0000",35,187,60576,0.15678330885704,21082,39494,0,0,0,232,0,232,166.98706896552,1770,1770,0,1770,0,21.887570621469,4.238418079096,0,71,179,179,0
"Sun Jul 8 00:43:45 2007 +0000",35,186,60562,0.15655824776165,21024,39538,0,0,0,231,0,231,167.78787878788,1768,1768,0,1768,0,21.922511312217,4.2409502262443,0,71,179,179,0
"Fri Jul 6 05:14:19 2007 +0000",35,185,60350,0.15702710254261,20981,39369,0,0,0,228,0,228,169.26754385965,1753,1753,0,1753,0,22.015402167712,4.2641186537365,0,71,179,179,0
"Sun Jul 1 03:43:05 2007 +0000",35,185,60263,0.15721268903712,20985,39278,0,0,0,228,0,228,168.86403508772,1753,1753,0,1753,0,21.962920707359,4.2601254991443,0,71,179,179,0
"Wed Jun 27 15:53:38 2007 +0000",35,185,59559,0.15953781186041,20960,38599,0,0,0,228,0,228,165.85526315789,1746,1746,0,1746,0,21.658075601375,4.2634593356243,0,71,179,179,0
"Tue Jun 26 19:02:10 2007 +0000",35,185,59463,0.15964707408849,20928,38535,0,0,0,228,0,228,165.56140350877,1743,1743,0,1743,0,21.656913367757,4.2656339644291,0,71,179,179,0
"Sat Jun 23 05:56:36 2007 +0000",34,184,59472,0.15970005967671,20931,38541,0,0,0,226,0,226,167.04424778761,1739,1739,0,1739,0,21.709028177113,4.2731454859114,0,71,179,179,0
"Fri Jun 22 04:13:29 2007 +0000",33,182,58213,0.16081886913002,20649,37564,0,0,0,223,0,223,164.82959641256,1698,1698,0,1698,0,21.647232037691,4.2856301531213,0,71,179,179,0
"Thu Jun 21 13:53:51 2007 +0000",33,182,58116,0.16052940548618,20640,37476,0,0,0,223,0,223,164.40358744395,1696,1696,0,1696,0,21.616745283019,4.2741745283019,0,71,179,179,0
"Wed Jun 20 03:47:31 2007 +0000",33,182,58105,0.16038969705058,20640,37465,0,0,0,223,0,223,164.36322869955,1696,1696,0,1696,0,21.611438679245,4.2700471698113,0,71,179,179,0
"Tue Jun 19 13:56:25 2007 +0000",33,182,58081,0.16035343423827,20620,37461,0,0,0,223,0,223,164.34977578475,1696,1696,0,1696,0,21.609669811321,4.2688679245283,0,71,179,179,0
"Sun Jun 17 01:04:28 2007 +0000",33,182,57981,0.16026702269693,20531,37450,0,0,0,223,0,223,164.29596412556,1695,1695,0,1695,0,21.615339233038,4.2678466076696,0,71,179,179,0
"Fri Jun 15 08:32:04 2007 +0000",33,182,57979,0.16022217474899,20531,37448,0,0,0,223,0,223,164.28251121076,1695,1695,0,1695,0,21.613569321534,4.2666666666667,0,71,179,179,0
"Sun Jun 10 06:20:39 2007 +0000",33,182,57996,0.16009931122858,20538,37458,0,0,0,223,0,223,164.32735426009,1696,1696,0,1696,0,21.606721698113,4.2629716981132,0,71,179,179,0
"Thu Jun 7 19:27:42 2007 +0000",33,182,57889,0.16000320915679,20496,37393,0,0,0,223,0,223,164.01793721973,1694,1694,0,1694,0,21.591499409681,4.2591499409681,0,71,178,178,0
"Tue Jun 5 17:06:00 2007 +0000",33,182,57852,0.15990364025696,20492,37360,0,0,0,223,0,223,163.86995515695,1693,1693,0,1693,0,21.584760779681,4.2557590076787,0,71,178,178,0
"Sun Jun 3 23:56:56 2007 +0000",33,182,57809,0.15981466106007,20472,37337,0,0,0,223,0,223,163.7533632287,1693,1693,0,1693,0,21.569403425871,4.2516243354991,0,71,178,178,0
"Fri Jun 1 17:27:10 2007 +0000",33,180,57697,0.15954461637136,20278,37419,0,0,0,218,0,218,167.87614678899,1683,1683,0,1683,0,21.745098039216,4.2727272727273,0,71,178,178,0
"Tue May 29 06:30:08 2007 +0000",33,180,57640,0.15936681105941,20242,37398,0,0,0,218,0,218,167.75688073394,1684,1684,0,1684,0,21.71674584323,4.2648456057007,0,71,178,178,0
"Sun May 27 00:42:02 2007 +0000",33,180,57615,0.15937257421237,20256,37359,0,0,0,218,0,218,167.8623853211,1681,1681,0,1681,0,21.769185008923,4.274241522903,0,73,178,178,0
"Sat May 26 09:00:54 2007 +0000",33,180,57253,0.15964445876635,20014,37239,0,0,0,218,0,218,167.22935779817,1670,1670,0,1670,0,21.82994011976,4.2922155688623,0,73,178,178,0
"Fri May 25 19:52:30 2007 +0000",33,180,57037,0.15962050151853,19830,37207,0,0,0,218,0,218,167.00458715596,1666,1666,0,1666,0,21.852941176471,4.296518607443,0,73,178,178,0
"Thu May 24 21:44:05 2007 +0000",33,180,56853,0.15998703683699,19825,37028,0,0,0,218,0,218,166.16972477064,1663,1663,0,1663,0,21.782922429345,4.2934455802766,0,73,178,178,0
"Thu May 24 04:42:33 2007 +0000",33,179,56663,0.16024181305574,19775,36888,0,0,0,217,0,217,166.3133640553,1656,1656,0,1656,0,21.79347826087,4.2995169082126,0,73,178,178,0
"Wed May 23 17:11:00 2007 +0000",33,179,56452,0.16008604727154,19728,36724,0,0,0,216,0,216,166.31481481481,1651,1651,0,1651,0,21.758933979406,4.290127195639,0,73,178,178,0
"Mon May 21 04:34:37 2007 +0000",33,178,55917,0.16017470607626,19513,36404,0,0,0,215,0,215,165.47906976744,1633,1633,0,1633,0,21.786895284752,4.2969993876301,0,73,178,178,0
"Sun May 20 06:27:09 2007 +0000",33,178,55694,0.16012973091829,19311,36383,0,0,0,215,0,215,165.33023255814,1632,1632,0,1632,0,21.780637254902,4.2959558823529,0,73,178,178,0
"Fri May 18 21:16:13 2007 +0000",33,178,56045,0.16037143247303,19430,36615,0,0,0,216,0,216,165.77777777778,1647,1647,0,1647,0,21.741347905282,4.2938676381299,0,73,178,178,0
"Tue May 15 18:47:02 2007 +0000",33,177,54178,0.16303821964199,19039,35139,0,0,0,214,0,214,160.10747663551,1603,1603,0,1603,0,21.374298190892,4.2950717404866,0,73,178,178,0
"Tue May 15 01:16:10 2007 +0000",33,177,54028,0.16359427248564,19039,34989,0,0,0,214,0,214,159.41121495327,1598,1598,0,1598,0,21.347934918648,4.30225281602,0,73,178,178,0
"Mon May 14 02:19:26 2007 +0000",33,175,53989,0.16339570972159,18933,35056,0,0,0,212,0,212,161.19339622642,1597,1597,0,1597,0,21.398246712586,4.3080776455855,0,73,180,180,0
"Sun May 13 21:54:48 2007 +0000",33,175,54115,0.16338996533894,18917,35198,0,0,0,212,0,212,161.32075471698,1604,1604,0,1604,0,21.321695760599,4.2923940149626,0,73,189,189,0
"Sun May 13 01:36:56 2007 +0000",33,176,53807,0.16377660334238,18802,35005,0,0,0,213,0,213,159.56807511737,1590,1590,0,1590,0,21.376100628931,4.3106918238994,0,73,189,189,0
"Sat May 12 21:02:50 2007 +0000",33,176,53711,0.16358219217327,18805,34906,0,0,0,213,0,213,159.10798122066,1588,1588,0,1588,0,21.341309823678,4.3003778337531,0,73,189,189,0
"Sat May 12 08:50:42 2007 +0000",33,176,53701,0.16353372686114,18803,34898,0,0,0,213,0,213,159.06572769953,1588,1588,0,1588,0,21.33564231738,4.2984886649874,0,73,189,189,0
"Wed May 9 02:09:56 2007 +0000",33,176,53565,0.16324594687823,18777,34788,0,0,0,213,0,213,158.53051643192,1584,1584,0,1584,0,21.317550505051,4.2891414141414,0,73,189,189,0
"Sat May 5 17:36:30 2007 +0000",33,176,53569,0.16309370067442,18724,34845,0,0,0,213,0,213,158.82629107981,1585,1585,0,1585,0,21.343848580442,4.2895899053628,0,73,187,187,0
"Fri May 4 20:12:08 2007 +0000",32,176,53518,0.16313157440938,18724,34794,0,0,0,213,0,213,158.58685446009,1585,1585,0,1585,0,21.31167192429,4.2851735015773,0,73,187,187,0
"Fri May 4 00:38:26 2007 +0000",32,176,53753,0.16309159978293,18742,35011,0,0,0,212,0,212,159.11320754717,1587,1587,0,1587,0,21.255198487713,4.2778827977316,0,85,208,208,0
"Thu May 3 04:35:25 2007 +0000",32,174,53965,0.16323053331062,18751,35214,0,0,0,211,0,211,160.57345971564,1593,1593,0,1593,0,21.268675455116,4.2818581293158,0,85,214,214,0
"Wed May 2 09:04:52 2007 +0000",32,174,54098,0.16302654315742,18797,35301,0,0,0,211,0,211,160.57819905213,1598,1598,0,1598,0,21.202753441802,4.2697121401752,0,85,223,223,0
"Tue May 1 13:09:35 2007 +0000",32,175,54889,0.16336702976674,19178,35711,0,0,0,211,0,211,162.57345971564,1648,1648,0,1648,0,20.814927184466,4.2111650485437,0,87,227,227,0
"Tue May 1 02:40:36 2007 +0000",32,175,54745,0.1633381084801,19144,35601,0,0,0,211,0,211,162.04265402844,1641,1641,0,1641,0,20.835466179159,4.2132845825716,0,87,227,227,0
"Mon Apr 30 13:03:13 2007 +0000",36,181,54951,0.16315538474486,19304,35647,0,0,0,211,0,211,162.0663507109,1641,1641,0,1641,0,20.838513101767,4.2132845825716,0,87,227,227,0
"Mon Apr 30 09:12:49 2007 +0000",36,180,54745,0.16317226240396,19212,35533,0,0,0,210,0,210,162.27142857143,1633,1633,0,1633,0,20.867728107777,4.2180036742192,0,87,227,227,0
"Sun Apr 29 20:51:59 2007 +0000",35,176,53896,0.16322926162261,18792,35104,0,0,0,205,0,205,164.11219512195,1593,1593,0,1593,0,21.119271814187,4.2592592592593,0,87,223,223,0
"Sun Apr 29 06:11:32 2007 +0000",35,176,53896,0.16323332478559,18799,35097,0,0,0,205,0,205,164.08780487805,1593,1593,0,1593,0,21.116133082235,4.2586315128688,0,87,223,223,0
"Sun Apr 29 03:05:08 2007 +0000",35,176,53803,0.16363792216698,18805,34998,0,0,0,205,0,205,163.6243902439,1591,1591,0,1591,0,21.082966687618,4.2614707730987,0,87,223,223,0
"Sat Apr 28 23:52:19 2007 +0000",35,173,53403,0.16491430217485,18688,34715,0,0,0,199,0,199,167.1959798995,1587,1587,0,1587,0,20.965343415249,4.2684310018904,0,87,223,223,0
"Thu Apr 26 11:54:36 2007 +0000",35,173,53318,0.16529904651835,18708,34610,0,0,0,199,0,199,166.71859296482,1583,1583,0,1583,0,20.958307012003,4.2741629816804,0,87,223,223,0
"Tue Apr 17 21:20:38 2007 +0000",35,173,52693,0.16558155903572,18595,34098,0,0,0,194,0,194,168.32474226804,1568,1568,0,1568,0,20.825892857143,4.2576530612245,0,87,223,223,0
"Tue Apr 17 04:30:23 2007 +0000",35,173,52480,0.16523662096418,18565,33915,0,0,0,193,0,193,168.21761658031,1561,1561,0,1561,0,20.798206278027,4.2453555413197,0,87,223,223,0
"Fri Apr 13 05:17:48 2007 +0000",35,172,52270,0.16505400207131,18475,33795,0,0,0,192,0,192,168.47916666667,1552,1552,0,1552,0,20.842783505155,4.2493556701031,0,87,222,222,0
"Wed Apr 11 21:22:26 2007 +0000",35,172,52098,0.16467475324058,18462,33636,0,0,0,192,0,192,167.70833333333,1550,1550,0,1550,0,20.774193548387,4.2309677419355,0,87,217,217,0
"Mon Apr 9 21:30:55 2007 +0000",35,172,51941,0.16577588277684,18637,33304,0,0,0,192,0,192,166.40104166667,1543,1543,0,1543,0,20.705767984446,4.2339598185353,0,87,217,217,0
"Sun Apr 8 00:14:04 2007 +0000",35,172,51749,0.16614306428226,18645,33104,0,0,0,192,0,192,165.36458333333,1544,1544,0,1544,0,20.563471502591,4.2182642487047,0,87,217,217,0
"Sat Apr 7 01:42:12 2007 +0000",35,172,51618,0.16670709520922,18638,32980,0,0,0,190,0,190,166.46842105263,1539,1539,0,1539,0,20.551656920078,4.227420402859,0,87,217,217,0
"Thu Apr 5 21:29:00 2007 +0000",35,172,51481,0.16697605063753,18620,32861,0,0,0,188,0,188,167.64361702128,1533,1533,0,1533,0,20.559034572733,4.2328767123288,0,87,217,217,0
"Thu Apr 5 16:09:51 2007 +0000",35,172,51470,0.16702720818988,18649,32821,0,0,0,188,0,188,167.53191489362,1532,1532,0,1532,0,20.558746736292,4.2317232375979,0,87,217,217,0
"Thu Apr 5 04:04:55 2007 +0000",35,171,51289,0.16721111280721,18534,32755,0,0,0,187,0,187,167.90909090909,1532,1532,0,1532,0,20.495430809399,4.2284595300261,0,87,217,217,0
"Wed Apr 4 20:38:26 2007 +0000",35,169,50885,0.16885640266469,18461,32424,0,0,0,183,0,183,169.8087431694,1531,1531,0,1531,0,20.297191378184,4.2292619203135,0,87,217,217,0
"Wed Apr 4 07:15:27 2007 +0000",35,169,50653,0.16865750364556,18422,32231,0,0,0,183,0,183,168.72677595628,1526,1526,0,1526,0,20.233944954128,4.2142857142857,0,87,217,217,0
"Mon Apr 2 19:20:50 2007 +0000",35,165,50328,0.16942548084417,18249,32079,0,0,0,174,0,174,176.68390804598,1526,1526,0,1526,0,20.146133682831,4.213630406291,0,87,217,217,0
"Sun Apr 1 07:47:56 2007 +0000",35,164,50115,0.17065425849656,18308,31807,0,0,0,169,0,169,180.3550295858,1521,1521,0,1521,0,20.039447731755,4.2195923734385,0,87,217,217,0
"Sat Mar 31 19:37:59 2007 +0000",35,163,49855,0.17017787309196,18147,31708,0,0,0,167,0,167,181.91017964072,1517,1517,0,1517,0,20.025708635465,4.2069874752802,0,87,217,217,0
"Thu Mar 29 02:21:50 2007 +0000",35,163,49269,0.16977132579651,18133,31136,0,0,0,167,0,167,179.26946107784,1501,1501,0,1501,0,19.945369753498,4.1845436375749,0,87,208,208,0
"Tue Mar 27 05:17:49 2007 +0000",35,162,49127,0.16987086593888,18074,31053,0,0,0,165,0,165,181.01212121212,1496,1496,0,1496,0,19.964572192513,4.192513368984,0,87,208,208,0
"Mon Mar 26 18:13:52 2007 +0000",35,162,49001,0.16986672690309,18012,30989,0,0,0,165,0,165,180.57575757576,1492,1492,0,1492,0,19.969839142091,4.1936997319035,0,87,208,208,0
"Sun Mar 25 02:03:34 2007 +0000",35,162,48736,0.17082383588408,18026,30710,0,0,0,159,0,159,185.72955974843,1485,1485,0,1485,0,19.886195286195,4.196632996633,0,87,208,208,0
"Fri Mar 23 16:06:48 2007 +0000",34,152,48130,0.16993871062895,17619,30511,0,0,0,150,0,150,195.5,1477,1477,0,1477,0,19.854434664861,4.1679079214624,0,88,208,208,0
"Fri Mar 23 02:00:10 2007 +0000",34,152,48107,0.17023020922149,17613,30494,0,0,0,150,0,150,195.36666666667,1475,1475,0,1474,1,19.867796610169,4.1762711864407,0,88,208,208,0
"Wed Mar 21 15:40:46 2007 +0000",33,150,47850,0.17056514136782,17539,30311,0,0,0,147,0,147,198.16326530612,1467,1467,0,1467,0,19.856850715746,4.1792774369461,0,88,208,208,0
"Sat Mar 17 19:15:41 2007 +0000",33,150,47689,0.17113347281724,17578,30111,0,0,0,146,0,146,198.34931506849,1466,1466,0,1466,0,19.753751705321,4.1746248294679,0,87,208,208,0
"Fri Mar 16 14:58:19 2007 +0000",33,150,45896,0.18019920458945,17483,28413,0,0,0,133,0,133,205.27819548872,1422,1422,0,1422,0,19.199718706048,4.2538677918425,0,87,206,206,0
"Wed Mar 14 20:47:39 2007 +0000",33,149,45736,0.18068414728956,17438,28298,0,0,0,132,0,132,205.97727272727,1414,1414,0,1414,0,19.228429985856,4.2673267326733,0,87,206,206,0
"Thu Mar 8 02:01:29 2007 +0000",33,145,44387,0.18121959249369,17050,27337,0,0,0,128,0,128,206.90625,1378,1378,0,1378,0,19.21915820029,4.27793904209,0,78,179,179,0
"Mon Mar 5 14:48:49 2007 +0000",33,145,44395,0.18132953049583,17047,27348,0,0,0,128,0,128,207.015625,1378,1378,0,1378,0,19.229317851959,4.2822931785196,0,78,179,179,0
"Sun Mar 4 12:14:33 2007 +0000",33,145,44641,0.18338597828849,17098,27543,0,0,0,128,0,128,208.578125,1375,1375,0,1375,0,19.416727272727,4.3563636363636,0,78,179,179,0
"Sun Mar 4 04:05:57 2007 +0000",33,145,44382,0.18253271916356,17028,27354,0,0,0,128,0,128,207.0390625,1368,1368,0,1368,0,19.372076023392,4.3311403508772,0,78,179,179,0
"Mon Feb 26 16:51:51 2007 +0000",33,145,44313,0.18231437048976,17014,27299,0,0,0,128,0,128,206.5859375,1364,1364,0,1364,0,19.386363636364,4.3299120234604,0,78,179,179,0
"Wed Feb 21 17:12:20 2007 +0000",33,143,43606,0.18216141452656,16855,26751,0,0,0,124,0,124,209.10483870968,1330,1330,0,1330,0,19.495488721805,4.3443609022556,0,77,178,178,0
"Mon Feb 19 04:30:48 2007 +0000",33,141,42778,0.18131159969674,16398,26380,0,0,0,122,0,122,208.70491803279,1309,1309,0,1309,0,19.451489686784,4.3307868601986,0,77,177,177,0
"Sat Feb 17 16:54:36 2007 +0000",33,141,42750,0.18135972396011,16377,26373,0,0,0,122,0,122,208.70491803279,1309,1309,0,1309,0,19.451489686784,4.331550802139,0,77,177,177,0
"Wed Feb 14 20:41:06 2007 +0000",34,141,42735,0.18130763100975,16382,26353,0,0,0,122,0,122,208.54918032787,1309,1309,0,1309,0,19.436974789916,4.327731092437,0,77,177,177,0
"Mon Feb 12 18:31:26 2007 +0000",34,140,42050,0.18096669750231,16106,25944,0,0,0,121,0,121,206.61157024793,1285,1285,0,1285,0,19.455252918288,4.3252918287938,0,77,177,177,0
"Sat Feb 10 17:19:49 2007 +0000",34,140,41833,0.18058891902363,16023,25810,0,0,0,121,0,121,205.4132231405,1278,1278,0,1278,0,19.448356807512,4.3169014084507,0,77,177,177,0
"Fri Feb 9 17:39:54 2007 +0000",34,140,41690,0.18047681913489,15936,25754,0,0,0,121,0,121,204.92561983471,1276,1276,0,1276,0,19.432601880878,4.3126959247649,0,77,176,176,0
"Thu Feb 8 18:36:26 2007 +0000",33,138,41610,0.18117802676626,15906,25704,0,0,0,119,0,119,207.99159663866,1270,1270,0,1270,0,19.488976377953,4.3362204724409,0,77,176,176,0
"Thu Feb 8 03:25:37 2007 +0000",33,138,41558,0.18103515472757,15900,25658,0,0,0,119,0,119,207.59663865546,1269,1269,0,1269,0,19.467297084318,4.3293932230102,0,77,176,176,0
"Tue Feb 6 14:23:36 2007 +0000",33,135,41343,0.18171500136981,15792,25551,0,0,0,115,0,115,214.08695652174,1259,1259,0,1259,0,19.5552025417,4.3542494042891,0,77,176,176,0
"Sun Feb 4 09:06:44 2007 +0000",33,135,41254,0.18158286924465,15756,25498,0,0,0,115,0,115,213.5652173913,1254,1254,0,1254,0,19.585326953748,4.3572567783094,0,77,176,176,0
"Sun Feb 4 02:17:36 2007 +0000",33,134,41186,0.18163249273313,15728,25458,0,0,0,115,0,115,213.48695652174,1253,1253,0,1253,0,19.593774940144,4.3583399840383,0,77,176,176,0
"Sat Feb 3 01:03:33 2007 +0000",25,114,38011,0.19546766619275,14800,23211,0,0,0,91,0,91,247.62637362637,1126,1126,0,1126,0,20.01243339254,4.6989342806394,0,70,150,150,0
"Fri Feb 2 13:31:21 2007 +0000",25,114,37988,0.19519558373226,14801,23187,0,0,0,91,0,91,247.36263736264,1125,1125,0,1125,0,20.008888888889,4.6924444444444,0,70,150,150,0
"Fri Feb 2 02:47:53 2007 +0000",25,114,38030,0.19500302062656,14856,23174,0,0,0,91,0,91,247.26373626374,1125,1125,0,1125,0,20.000888888889,4.6862222222222,0,70,150,150,0
"Thu Feb 1 07:35:52 2007 +0000",25,114,37996,0.19498703543647,14856,23140,0,0,0,91,0,91,246.9010989011,1125,1125,0,1125,0,19.971555555556,4.68,0,70,150,150,0
"Thu Feb 1 03:02:08 2007 +0000",25,114,37979,0.19490682692723,14850,23129,0,0,0,91,0,91,246.81318681319,1125,1125,0,1125,0,19.964444444444,4.6782222222222,0,70,150,150,0
"Wed Jan 31 22:43:32 2007 +0000",25,114,37955,0.19490131578947,14851,23104,0,0,0,91,0,91,246.53846153846,1126,1126,0,1126,0,19.924511545293,4.6705150976909,0,70,150,150,0
"Wed Jan 31 18:49:30 2007 +0000",25,114,37946,0.19498788088643,14842,23104,0,0,0,91,0,91,246.51648351648,1126,1126,0,1126,0,19.922735346359,4.6722912966252,0,70,150,150,0
"Sat Jan 27 18:17:23 2007 +0000",25,114,37949,0.19508814484342,14862,23087,0,0,0,91,0,91,246.40659340659,1123,1123,0,1123,0,19.967052537845,4.6821015138023,0,69,150,150,0
"Wed Jan 24 07:26:52 2007 +0000",25,113,37654,0.19536972445065,14718,22936,0,0,0,90,0,90,247.33333333333,1110,1110,0,1110,0,20.054054054054,4.7054054054054,0,69,150,150,0
"Mon Jan 22 08:22:10 2007 +0000",25,113,37496,0.19514758693177,14662,22834,0,0,0,90,0,90,246.12222222222,1105,1105,0,1105,0,20.046153846154,4.6995475113122,0,69,149,149,0
"Sat Jan 20 15:29:06 2007 +0000",25,113,37258,0.19441133624685,14605,22653,0,0,0,90,0,90,244.05555555556,1098,1098,0,1098,0,20.004553734062,4.6757741347905,0,69,149,149,0
"Tue Jan 16 07:07:49 2007 +0000",25,113,37223,0.19454513305632,14601,22622,0,0,0,90,0,90,243.75555555556,1098,1098,0,1098,0,19.979963570128,4.6739526411658,0,69,149,149,0
"Fri Jan 12 16:37:56 2007 +0000",25,112,36746,0.19407997850522,14415,22331,0,0,0,89,0,89,244.1797752809,1091,1091,0,1091,0,19.919340054995,4.6608615948671,0,68,149,149,0
"Tue Jan 9 22:36:29 2007 +0000",25,112,36607,0.19404927523224,14324,22283,0,0,0,89,0,89,243.51685393258,1090,1090,0,1090,0,19.883486238532,4.6559633027523,0,68,149,149,0
"Sat Jan 6 16:37:03 2007 +0000",25,112,36523,0.19397812682839,14304,22219,0,0,0,89,0,89,242.89887640449,1088,1088,0,1088,0,19.869485294118,4.6516544117647,0,68,149,149,0
"Fri Jan 5 21:48:40 2007 +0000",25,112,36413,0.19359205776173,14253,22160,0,0,0,89,0,89,242.06741573034,1084,1084,0,1084,0,19.874538745387,4.6466789667897,0,68,149,149,0
"Wed Jan 3 17:36:14 2007 +0000",25,112,36354,0.19312372766342,14249,22105,0,0,0,89,0,89,241.48314606742,1084,1084,0,1084,0,19.826568265683,4.6282287822878,0,68,148,148,0
"Sat Dec 30 01:02:19 2006 +0000",25,111,36087,0.19289779194173,14122,21965,0,0,0,88,0,88,242.44318181818,1069,1069,0,1069,0,19.957904583723,4.6492048643592,0,68,148,148,0
"Thu Dec 28 03:48:04 2006 +0000",25,111,36103,0.19286104534693,14139,21964,0,0,0,88,0,88,242.39772727273,1069,1069,0,1069,0,19.954162768943,4.6463985032741,0,68,148,148,0
"Tue Dec 26 16:17:37 2006 +0000",25,110,35618,0.19250943222601,13884,21734,0,0,0,87,0,87,242.32183908046,1055,1055,0,1055,0,19.982938388626,4.6464454976303,0,68,148,148,0
"Mon Dec 25 08:03:33 2006 +0000",25,110,35393,0.19214495952907,13649,21744,0,0,0,87,0,87,241.93103448276,1056,1056,0,1056,0,19.931818181818,4.6382575757576,0,68,152,152,0
"Sun Dec 24 19:34:29 2006 +0000",25,110,35238,0.19213005726954,13586,21652,0,0,0,87,0,87,241.04597701149,1053,1053,0,1053,0,19.915479582146,4.633428300095,0,67,148,148,0
"Sun Dec 24 04:32:22 2006 +0000",25,110,34950,0.19205978514713,13540,21410,0,0,0,87,0,87,238.28735632184,1045,1045,0,1045,0,19.838277511962,4.6153110047847,0,67,148,148,0
"Sat Dec 23 16:19:52 2006 +0000",25,110,34926,0.19193005423602,13538,21388,0,0,0,87,0,87,238.04597701149,1045,1045,0,1045,0,19.818181818182,4.6086124401914,0,67,148,148,0
"Sat Dec 23 09:09:06 2006 +0000",25,110,34926,0.19193005423602,13538,21388,0,0,0,87,0,87,238.04597701149,1045,1045,0,1045,0,19.818181818182,4.6086124401914,0,67,148,148,0
"Sat Dec 23 02:10:41 2006 +0000",25,110,34924,0.19194800336669,13538,21386,0,0,0,87,0,87,238.02298850575,1045,1045,0,1045,0,19.816267942584,4.6086124401914,0,67,148,148,0
"Sat Dec 23 00:17:52 2006 +0000",25,110,34922,0.19196595585484,13538,21384,0,0,0,87,0,87,238,1045,1045,0,1045,0,19.814354066986,4.6086124401914,0,67,148,148,0
"Fri Dec 22 07:38:31 2006 +0000",25,110,35496,0.18640440741247,13533,21963,0,0,0,87,0,87,244.64367816092,1045,1045,0,1045,0,20.367464114833,4.5980861244019,0,67,148,148,0
"Tue Dec 19 19:27:19 2006 +0000",25,110,36381,0.18052594171997,13869,22512,0,0,0,87,0,87,255.2183908046,1043,1043,0,1043,0,21.288590604027,4.5762224352828,0,67,148,148,0
"Tue Dec 12 22:43:01 2006 +0000",25,110,36255,0.18004996431121,13839,22416,0,0,0,87,0,87,254.05747126437,1039,1039,0,1039,0,21.273339749759,4.5620789220404,0,67,148,148,0
"Fri Dec 8 08:59:35 2006 +0000",25,110,36287,0.17986284289277,13831,22456,0,0,0,87,0,87,254.47126436782,1039,1039,0,1039,0,21.307988450433,4.5649663137632,0,67,148,148,0
"Mon Dec 4 18:00:36 2006 +0000",25,110,35989,0.1794353933845,13708,22281,0,0,0,87,0,87,252.64367816092,1031,1031,0,1031,0,21.319107662464,4.560620756547,0,65,148,148,0
"Fri Dec 1 01:24:42 2006 +0000",25,109,35384,0.17950462710942,13340,22044,0,0,0,86,0,86,252.31395348837,1016,1016,0,1016,0,21.357283464567,4.5718503937008,0,65,149,149,0
"Wed Nov 29 08:14:55 2006 +0000",25,109,35522,0.17918057937009,13360,22162,0,0,0,86,0,86,253.6976744186,1017,1017,0,1017,0,21.453294001967,4.5821042281219,0,65,149,149,0
"Tue Nov 28 22:34:28 2006 +0000",25,109,35858,0.1792018590517,13481,22377,0,0,0,86,0,86,256.41860465116,1028,1028,0,1028,0,21.451361867704,4.5817120622568,0,65,149,149,0
"Mon Nov 27 20:15:24 2006 +0000",25,109,35692,0.17888839085612,13382,22310,0,0,0,86,0,86,255.47674418605,1027,1027,0,1027,0,21.393378773126,4.5666991236611,0,65,149,149,0
"Mon Nov 27 04:46:00 2006 +0000",25,109,35685,0.17860185641899,13384,22301,0,0,0,86,0,86,255.3488372093,1027,1027,0,1027,0,21.382667964946,4.5589094449854,0,65,149,149,0
"Sun Nov 26 00:06:20 2006 +0000",25,109,35634,0.17921050265264,13392,22242,0,0,0,86,0,86,254.55813953488,1023,1023,0,1023,0,21.399804496579,4.5757575757576,0,65,149,149,0
"Sat Nov 25 09:27:01 2006 +0000",25,109,35609,0.17862451020132,13406,22203,0,0,0,86,0,86,254.12790697674,1025,1025,0,1025,0,21.321951219512,4.5492682926829,0,65,149,149,0
"Fri Nov 24 12:30:59 2006 +0000",25,109,35376,0.17858759619737,13286,22090,0,0,0,84,0,84,258.67857142857,1014,1014,0,1014,0,21.42899408284,4.5670611439842,0,65,149,149,0
"Thu Nov 23 10:48:22 2006 +0000",25,109,35353,0.17864262413918,13281,22072,0,0,0,84,0,84,258.45238095238,1011,1011,0,1011,0,21.473788328388,4.5766567754698,0,65,149,149,0
"Wed Nov 22 21:32:59 2006 +0000",25,109,35326,0.17861030478955,13278,22048,0,0,0,84,0,84,258.27380952381,1011,1011,0,1011,0,21.458951533136,4.5746785361029,0,65,148,148,0
"Wed Nov 22 04:27:23 2006 +0000",25,109,35308,0.1786200635497,13278,22030,0,0,0,84,0,84,258.09523809524,1011,1011,0,1011,0,21.444114737883,4.5717111770524,0,65,148,148,0
"Tue Nov 21 20:17:26 2006 +0000",25,110,35409,0.17870429180655,13367,22042,0,0,0,84,0,84,257.7619047619,1011,1011,0,1011,0,21.416419386746,4.5776458951533,0,65,148,148,0
"Wed Nov 15 03:08:41 2006 +0000",25,110,35363,0.17795460710733,13245,22118,0,0,0,84,0,84,257.5,1011,1011,0,1011,0,21.394658753709,4.5746785361029,0,65,148,148,0
"Thu Nov 9 16:26:54 2006 +0000",25,110,35356,0.17766612348361,13264,22092,0,0,0,84,0,84,257.08333333333,1009,1009,0,1009,0,21.402378592666,4.5688800792864,0,66,148,148,0
"Wed Nov 8 01:56:07 2006 +0000",25,110,35112,0.17691605839416,13192,21920,0,0,0,84,0,84,254.92857142857,1003,1003,0,1003,0,21.349950149551,4.543369890329,0,66,148,148,0
"Fri Nov 3 19:38:54 2006 +0000",25,110,35170,0.17614437019865,13171,21999,0,0,0,84,0,84,255.96428571429,1003,1003,0,1003,0,21.436689930209,4.5413758723829,0,66,148,148,0
"Thu Nov 2 03:51:26 2006 +0000",25,110,35019,0.17576643669758,13132,21887,0,0,0,84,0,84,254.55952380952,998,998,0,998,0,21.425851703407,4.5310621242485,0,66,148,148,0
"Wed Nov 1 04:54:25 2006 +0000",25,110,34965,0.17579950517731,13139,21826,0,0,0,84,0,84,253.90476190476,995,995,0,995,0,21.435175879397,4.5316582914573,0,66,148,148,0
"Tue Oct 31 05:01:48 2006 +0000",25,110,34988,0.17544342087172,13169,21819,0,0,0,84,0,84,253.85714285714,997,997,0,997,0,21.38816449348,4.5155466399198,0,66,150,150,0
"Sat Oct 28 00:42:51 2006 +0000",25,110,34967,0.17538066409833,13163,21804,0,0,0,84,0,84,253.7380952381,995,995,0,995,0,21.421105527638,4.5206030150754,0,65,150,150,0
"Thu Oct 26 16:29:10 2006 +0000",25,108,34847,0.17527573529412,13087,21760,0,0,0,82,0,82,259.5487804878,991,991,0,991,0,21.476286579213,4.5267406659939,0,65,149,149,0
"Fri Oct 20 21:58:43 2006 +0000",25,107,34675,0.17544996067182,13062,21613,0,0,0,81,0,81,261.12345679012,985,985,0,985,0,21.473096446701,4.5289340101523,0,65,147,147,0
"Thu Oct 19 04:55:07 2006 +0000",25,107,34552,0.1756970260223,13032,21520,0,0,0,81,0,81,260.01234567901,982,982,0,982,0,21.447046843177,4.5295315682281,0,65,146,146,0
"Wed Oct 18 12:55:19 2006 +0000",25,108,34727,0.17629109066531,13098,21629,0,0,0,81,0,81,260.59259259259,982,982,0,982,0,21.494908350306,4.5529531568228,0,68,146,146,0
"Tue Oct 17 17:39:48 2006 +0000",25,108,34612,0.17597402597403,13052,21560,0,0,0,81,0,81,259.71604938272,981,981,0,981,0,21.444444444444,4.5372069317023,0,68,146,146,0
"Sun Oct 15 08:13:41 2006 +0000",25,108,34566,0.17598699489085,13036,21530,0,0,0,81,0,81,259.34567901235,980,980,0,980,0,21.435714285714,4.5357142857143,0,68,146,146,0
"Sat Oct 14 17:21:28 2006 +0000",25,108,34405,0.17600262061865,13036,21369,0,0,0,81,0,81,257.35802469136,979,979,0,979,0,21.29315628192,4.5107252298264,0,68,146,146,0
"Fri Oct 13 04:45:12 2006 +0000",25,108,34390,0.17607942305891,13036,21354,0,0,0,81,0,81,257.18518518519,977,977,0,977,0,21.32241555783,4.5168884339816,0,68,146,146,0
"Mon Oct 9 23:44:20 2006 +0000",25,107,34020,0.17620560481768,12931,21089,0,0,0,80,0,80,257.225,966,966,0,966,0,21.302277432712,4.5144927536232,0,68,146,146,0
"Sun Oct 8 15:30:32 2006 +0000",25,107,33850,0.17579745386926,12877,20973,0,0,0,80,0,80,255.8375,958,958,0,958,0,21.364300626305,4.5135699373695,0,68,140,140,0
"Fri Sep 29 01:30:09 2006 +0000",25,107,33667,0.17478854286813,12859,20808,0,0,0,80,0,80,253.75,955,955,0,955,0,21.256544502618,4.4722513089005,0,68,140,140,0
"Thu Sep 28 20:26:54 2006 +0000",25,107,33539,0.17449599691328,12805,20734,0,0,0,80,0,80,252.7,952,952,0,952,0,21.235294117647,4.4632352941176,0,68,140,140,0
"Fri Sep 22 17:52:13 2006 +0000",25,107,33516,0.17440007725363,12805,20711,0,0,0,80,0,80,252.4125,951,951,0,951,0,21.233438485804,4.4605678233438,0,68,140,140,0
"Wed Sep 20 04:43:28 2006 +0000",25,107,33295,0.17306194000779,12759,20536,0,0,0,80,0,80,250.225,946,946,0,946,0,21.16067653277,4.4207188160677,0,68,140,140,0
"Mon Sep 18 20:11:40 2006 +0000",25,107,33271,0.17282566302652,12759,20512,0,0,0,80,0,80,249.925,946,946,0,946,0,21.135306553911,4.4112050739958,0,68,140,140,0
"Fri Sep 15 02:13:21 2006 +0000",25,107,33286,0.17299166950845,12759,20527,0,0,0,80,0,80,250.3,946,946,0,946,0,21.167019027484,4.4196617336152,0,68,140,140,0
"Tue Sep 12 01:55:32 2006 +0000",25,107,33271,0.17297666033231,12748,20523,0,0,0,80,0,80,250.1875,946,946,0,946,0,21.157505285412,4.4186046511628,0,68,140,140,0
"Sun Sep 10 17:30:29 2006 +0000",25,105,32928,0.17313771981822,12684,20244,0,0,0,78,0,78,253.08974358974,932,932,0,932,0,21.181330472103,4.4216738197425,0,68,140,140,0
"Tue Sep 5 18:10:59 2006 +0000",25,104,32747,0.17327569071755,12623,20124,0,0,0,77,0,77,255.11688311688,923,923,0,923,0,21.282773564464,4.4398699891658,0,66,140,140,0
"Tue Aug 29 06:07:31 2006 +0000",25,104,32608,0.17350913994606,12586,20022,0,0,0,77,0,77,254.05194805195,916,916,0,916,0,21.355895196507,4.4596069868996,0,66,140,140,0
"Tue Aug 22 12:08:44 2006 +0000",25,104,32496,0.17260232744783,12560,19936,0,0,0,77,0,77,252.92207792208,914,914,0,914,0,21.307439824945,4.4321663019694,0,66,140,140,0
"Sun Aug 20 22:21:22 2006 +0000",25,102,31966,0.17111946363267,12278,19688,0,0,0,75,0,75,255.89333333333,899,899,0,899,0,21.348164627364,4.4093437152392,0,66,140,140,0
"Fri Aug 18 07:53:45 2006 +0000",25,101,31801,0.16891788572302,12182,19619,0,0,0,74,0,74,258.32432432432,887,887,0,887,0,21.551296505073,4.3945885005637,0,66,142,142,0
"Sat Aug 12 01:18:28 2006 +0000",24,99,31564,0.16935566745453,12102,19462,0,0,0,73,0,73,261.15068493151,885,885,0,885,0,21.541242937853,4.3898305084746,0,57,133,133,0
"Mon Aug 7 11:32:42 2006 +0000",24,99,31387,0.16852245067067,12078,19309,0,0,0,73,0,73,259.02739726027,883,883,0,883,0,21.41449603624,4.3499433748584,0,57,133,133,0
"Sun Aug 6 17:55:01 2006 +0000",24,99,31298,0.16826948068826,12061,19237,0,0,0,73,0,73,258.08219178082,880,880,0,880,0,21.409090909091,4.3431818181818,0,57,132,132,0
"Tue Aug 1 21:26:00 2006 +0000",24,99,31240,0.16818679314119,12053,19187,0,0,0,73,0,73,257.39726027397,878,878,0,878,0,21.400911161731,4.3394077448747,0,57,132,132,0
"Sun Jul 30 12:24:03 2006 +0000",24,99,31183,0.16723299702023,12054,19129,0,0,0,73,0,73,256.65753424658,878,878,0,878,0,21.339407744875,4.3086560364465,0,57,132,132,0
"Sat Jul 29 05:58:31 2006 +0000",24,98,32674,0.1690681557561,12617,20057,0,0,0,72,0,72,274.16666666667,930,930,0,930,0,21.225806451613,4.3204301075269,0,57,132,132,0
"Sun Jul 23 18:59:52 2006 +0000",24,97,32438,0.16798915226999,12526,19912,0,0,0,71,0,71,275.87323943662,923,923,0,923,0,21.221018418202,4.2957746478873,0,57,132,132,0
"Fri Jul 21 08:03:03 2006 +0000",24,96,31896,0.16690537084399,12346,19550,0,0,0,70,0,70,274.94285714286,910,910,0,910,0,21.149450549451,4.2593406593407,0,56,131,131,0
"Fri Jul 7 19:46:19 2006 +0000",24,97,32098,0.16521650638579,12445,19653,0,0,0,71,0,71,272.87323943662,926,926,0,926,0,20.922246220302,4.1900647948164,0,58,130,130,0
"Thu Jul 6 13:04:21 2006 +0000",24,97,32011,0.16031778366266,12375,19636,0,0,0,71,0,71,266.08450704225,913,913,0,913,0,20.692223439211,4.1226725082147,0,58,130,130,0
"Tue Jun 27 10:29:35 2006 +0000",24,97,31844,0.16442020784031,12406,19438,0,0,0,71,0,71,270.54929577465,923,923,0,923,0,20.811484290358,4.1570964247021,0,57,130,130,0
"Thu Jun 22 21:07:03 2006 +0000",24,97,31838,0.16434196304493,12409,19429,0,0,0,71,0,71,270.42253521127,923,923,0,923,0,20.80173347779,4.1538461538462,0,57,130,130,0
"Mon Jun 19 02:55:53 2006 +0000",24,97,31820,0.16429748660898,12404,19416,0,0,0,71,0,71,270.29577464789,922,922,0,922,0,20.81453362256,4.1540130151844,0,57,130,130,0
"Fri Jun 16 21:02:38 2006 +0000",24,97,31885,0.16335586399051,12504,19381,0,0,0,71,0,71,270.16901408451,936,936,0,936,0,20.49358974359,4.0833333333333,0,57,130,130,0
"Thu Jun 15 14:39:34 2006 +0000",24,97,31670,0.16115272575947,12446,19224,0,0,0,71,0,71,267.84507042254,929,929,0,929,0,20.470398277718,4.0355220667384,0,57,130,130,0
"Wed Jun 14 23:43:59 2006 +0000",24,97,31571,0.16083916083916,12409,19162,0,0,0,71,0,71,266.98591549296,926,926,0,926,0,20.470842332613,4.0280777537797,0,55,130,130,0
"Tue May 9 02:15:47 2006 +0000",22,87,30177,0.13141893618108,10606,19571,0,0,0,60,0,60,305.83333333333,805,805,0,805,0,22.795031055901,3.895652173913,0,46,125,125,0
"Mon Apr 24 21:22:56 2006 +0000",18,77,27773,0.13127197633532,9856,17917,0,0,0,59,0,59,288.33898305085,769,769,0,769,0,22.122236671001,3.7958387516255,0,43,96,96,0
"Sun Mar 26 17:31:33 2006 +0000",18,77,25394,0.13157555440949,9882,15512,0,0,0,58,0,58,252.51724137931,736,736,0,736,0,19.899456521739,3.5095108695652,0,43,95,95,0
"Tue Mar 14 13:58:29 2006 +0000",18,75,24561,0.13161411010155,9593,14968,0,0,0,57,0,57,247.70175438596,720,720,0,720,0,19.609722222222,3.4777777777778,0,43,93,93,0
"Sun Mar 12 08:06:12 2006 +0000",18,74,24146,0.13163279225208,9484,14662,0,0,0,56,0,56,247.07142857143,705,705,0,705,0,19.625531914894,3.4808510638298,0,42,93,93,0
"Wed Mar 1 19:13:48 2006 +0000",18,73,23497,0.1298399040835,9318,14179,0,0,0,55,0,55,244.76363636364,690,690,0,690,0,19.510144927536,3.4376811594203,0,40,91,91,0
"Wed Feb 22 18:35:41 2006 +0000",18,72,23059,0.12767805442965,9243,13816,0,0,0,55,0,55,238.94545454545,682,682,0,682,0,19.269794721408,3.3607038123167,0,40,81,81,0
"Sun Feb 19 01:54:39 2006 +0000",18,73,23250,0.12761037647229,9411,13839,0,0,0,56,0,56,235.07142857143,690,690,0,690,0,19.078260869565,3.331884057971,0,40,80,80,0
"Fri Feb 3 07:12:40 2006 +0000",18,73,22553,0.12357169882709,9338,13215,0,0,0,56,0,56,225.16071428571,681,681,0,681,0,18.515418502203,3.1850220264317,0,38,78,78,0
"Wed Jan 25 22:40:17 2006 +0000",18,72,21853,0.12314843996218,9161,12692,0,0,0,55,0,55,221.23636363636,662,662,0,662,0,18.380664652568,3.166163141994,0,35,77,77,0
"Tue Jan 17 22:13:15 2006 +0000",18,72,21583,0.1222472271339,9141,12442,0,0,0,55,0,55,216.98181818182,656,656,0,656,0,18.192073170732,3.1265243902439,0,35,77,77,0
"Fri Jan 13 07:15:10 2006 +0000",18,71,21159,0.12247218387071,8846,12313,0,0,0,55,0,55,214.05454545455,651,651,0,651,0,18.084485407066,3.1213517665131,0,35,76,76,0
"Fri Jan 6 04:46:42 2006 +0000",17,68,18107,0.12735757340074,7821,10286,0,0,0,52,0,52,187.5,536,536,0,536,0,18.190298507463,3.2350746268657,0,26,95,95,0
"Wed Dec 28 17:23:12 2005 +0000",17,68,18020,0.12687078157097,7797,10223,0,0,0,52,0,52,187.05769230769,536,536,0,536,0,18.147388059701,3.2220149253731,0,24,95,95,0
"Fri Dec 23 22:04:03 2005 +0000",17,67,17217,0.12591297191647,7496,9721,0,0,0,51,0,51,180.96078431373,518,518,0,518,0,17.816602316602,3.1891891891892,0,24,94,94,0
"Wed Nov 2 03:24:04 2005 +0000",29,92,16975,0.12311641924322,8016,8959,0,0,0,45,0,45,185.08888888889,489,489,0,489,0,17.032719836401,3.0715746421268,0,24,88,88,0
"Sat Oct 29 01:23:04 2005 +0000",29,92,16862,0.1234987536823,8036,8826,0,0,0,45,0,45,182.73333333333,484,484,0,484,0,16.989669421488,3.0723140495868,0,23,88,88,0
"Mon Oct 24 09:54:24 2005 +0000",29,89,15981,0.12546703627817,7684,8297,0,0,0,42,0,42,182.71428571429,454,454,0,454,0,16.903083700441,3.0969162995595,0,23,85,85,0
"Sun Oct 9 01:56:21 2005 +0000",27,91,16706,0.12650882079851,8090,8616,0,0,0,45,0,45,180.33333333333,484,484,0,484,0,16.76652892562,3.0681818181818,0,23,84,84,0
"Thu Sep 29 17:31:23 2005 +0000",22,90,15652,0.13375116682224,8153,7499,0,0,0,47,0,47,158.46808510638,440,440,0,440,0,16.927272727273,3.1045454545455,0,22,76,76,0
"Mon Sep 19 01:16:05 2005 +0000",68,290,49723,0.081908506828635,21240,28483,0,0,0,442,0,442,62.486425339367,2409,2409,0,2409,0,11.464923204649,1.901203819012,2,29,118,118,0
"Wed Sep 14 04:11:56 2005 +0000",67,289,49430,0.08162471719457,21142,28288,0,0,0,441,0,441,62.326530612245,2403,2403,0,2403,0,11.438202247191,1.8955472326259,2,23,119,119,0
"Thu Aug 25 16:40:50 2005 +0000",68,285,47415,0.0784032598853,20911,26504,0,0,0,433,0,433,60.050808314088,2336,2336,0,2336,0,11.130993150685,1.8411815068493,0,20,102,102,0
"Sat Jul 30 02:23:57 2005 +0000",17,124,37011,0.075372904474854,14284,22727,0,0,0,279,0,279,83.874551971326,2179,2179,0,2179,0,10.739329967875,1.7430013767783,0,17,117,117,0
"Sun Jul 10 05:08:19 2005 +0000",17,119,35626,0.073570352790836,13715,21911,0,0,0,274,0,274,82.105839416058,2154,2154,0,2154,0,10.444289693593,1.7056638811513,0,17,113,113,0
"Mon Jul 4 01:49:09 2005 +0000",17,119,34375,0.072667217175888,12577,21798,0,0,0,274,0,274,80.700729927007,2146,2146,0,2146,0,10.303821062442,1.695246971109,0,17,113,113,0
"Mon Jul 4 00:53:17 2005 +0000",17,119,34232,0.072635445362718,12452,21780,0,0,0,275,0,275,80.334545454545,2146,2146,0,2146,0,10.29450139795,1.6943150046598,0,17,113,113,0
"Sat Jul 2 04:36:18 2005 +0000",17,119,34718,0.074308729691813,12621,22097,0,0,0,274,0,274,81.773722627737,2177,2177,0,2177,0,10.292145153881,1.7119889756546,0,17,113,113,0
"Thu Jun 23 13:59:02 2005 +0000",17,119,34767,0.074385014669375,12612,22155,0,0,0,274,0,274,82.065693430657,2181,2181,0,2181,0,10.30994956442,1.7138927097662,0,17,113,113,0
"Mon Jun 20 23:08:59 2005 +0000",14,114,33926,0.073399990784684,12223,21703,0,0,0,271,0,271,81.107011070111,2148,2148,0,2148,0,10.232774674115,1.6997206703911,0,17,113,113,0
"Sun Jun 12 20:50:12 2005 +0000",9,47,9188,0.13304093567251,5084,4104,0,0,0,42,0,42,105.7619047619,402,402,0,402,0,11.049751243781,2.2388059701493,0,14,72,72,0
"Wed Jun 1 21:30:39 2005 +0000",8,45,8533,0.13872989915508,4864,3669,0,0,0,41,0,41,98.146341463415,383,383,0,383,0,10.506527415144,2.2323759791123,0,15,71,71,0
"Sat May 21 22:51:26 2005 +0000",6,41,7410,0.12915006640106,4398,3012,0,0,0,36,0,36,94.416666666667,333,333,0,333,0,10.207207207207,2.0840840840841,0,12,65,65,0
"Tue May 17 22:04:09 2005 +0000",6,40,7419,0.13371505557427,4450,2969,0,0,0,35,0,35,95.742857142857,325,325,0,325,0,10.310769230769,2.1076923076923,0,15,59,59,0
"Mon May 16 23:14:37 2005 +0000",5,32,5616,0.16444826105625,3287,2329,0,0,0,27,0,27,95.333333333333,256,256,0,256,0,10.0546875,2.34765625,0,15,58,58,0
